originals	tokenized	transliterated
aääoe	a ä ä oe	a ʔ a ʔ a u
aäpoe(w)a(q)	a ä p oe ( w ) a ( q )	a ʔ a p u ( w ) a ( ʔ )
aba	a b a	a b a
abaiekahaieq	a b a ie k a h a ie q	a b a i k a h a i ʔ
abakoe(w)a(q)	a b a k oe ( w ) a ( q )	a b a k u ( w ) a ( ʔ )
abaoe(w)aie(j)onie(j)a	a b a oe ( w ) a ie ( j ) o n ie ( j ) a	a b a u ( w ) a i ( j ) o n i ( j ) a
abapoe(w)apaoe(w)a	a b a p oe ( w ) a p a oe ( w ) a	a b a p u ( w ) a p a u ( w ) a
abèha	a b è h a	a b ɛ h a
abèo	a b è o	a b ɛ o
aboeaqä	a b oe a qä	a b u a ʔ a
aböha	a b ö h a	a b ɨ h a
adèq	a d è q	a d ɛ ʔ
adie	a d ie	a d i
adieba	a d ie b a	a d i b a
adieba hie adoe(w)a	a d ie b a # h ie # a d oe ( w ) a	a d i b a # h i # a d u ( w ) a
ado	a d o	a d o
adoe(w)a	a d oe ( w ) a	a d u ( w ) a
ahadie	a h a d ie	a h a d i
ahado	a h a d o	a h a d o
ahapieorie	a h a p ie o r ie	a h a p i o r i
ahapoie	a h a p o ie	a h a p o i
aharie	a h a r ie	a h a r i
aharieohoie	a h a r ie o h o ie	a h a r i o h o i
ahèmoie	a h è m o ie	a h ɛ m o i
ahiebie	a h ie b ie	a h i b i
ahiemahona	a h ie m a h o n a	a h i m a h o n a
ahopaq	a h o p a q	a h o p a ʔ
aieiejo	a ie ie j o	a i i j o
aiekoie	a ie k o ie	a i k o i
aiekoie(j)aq	a ie k o ie ( j ) a q	a i k o i ( j ) a ʔ
ajoqoie	a j o q o ie	a j o ʔ o i
akieäkiena	a k ie ä k ie n a	a k i ʔ a k i n a
akiedaq	a k ie d a q	a k i d a ʔ
akiedaqöö	a k ie d a q ö ö	a k i d a ʔ ɨ ɨ
oe(w)aho bakiekiedaq	oe ( w ) a h o # b a k ie k ie d a q	u ( w ) a h o # b a k i k i d a ʔ
akiehaäq	a k ie h a ä q	a k i ç a ʔ a ʔ
akienaie	a k ie n a ie	a k i n a i
akohaie; maäkohaie	a k o h a ie ; # m a ä k o h a ie	a k o h a i ; # m a ʔ a k o h a i
akoloe	a k o l oe	a k o l u
ama	a m a	a m a
amahèaqja	a m a h è a q j a	a m a h ɛ a ʔ j a
amanaie	a m a n a ie	a m a n a i
amĕnaq	a m ĕ n a q	a m ə n a ʔ
amĕno	a m ĕ n o	a m ə n o
amèq	a m è q	a m ɛ ʔ
amoeapo	a m oe a p o	a m u a p o
amoehoe; èienoeqoe(q)	a m oe h oe ; # è ie n oe q oe ( q )	a m u h u ; # ɛ i n u ʔ u ( ʔ )
èkariehie	è k a r ie h ie	ɛ k a r i ç i
èkienè	è k ie n è	ɛ k i n ɛ
ana	a n a	a n a
aniemaie	a n ie m a ie	a n i m a i
anoekoöq	a n oe k o ö q	a n u k o ʔ o ʔ
anohakèkè	a n o h a k è k è	a n o h a k ɛ k ɛ
anoqö	a n o q ö	a n o ʔ ɨ
anokè	a n o k è	a n o k ɛ
anokie	a n o k ie	a n o k i
anoöho	a n o ö h o	a n o ʔ o h o
anoqè(j)a	a n o q è ( j ) a	a n o ʔ ɛ ( j ) a
aoe	a oe	a u
aoedoe	a oe d oe	a u d u
a(o)pa	a ( o ) p a	a ( o ) p a
a(o)pahiea(o)pa	a ( o ) p a h ie a ( o ) p a	a ( o ) p a h i a ( o ) p a
apieaie	a p ie a ie	a p i a i
a(p)ie(j)aka	a ( p ) ie ( j ) a k a	a ( p ) i ( j ) a k a
kie(a)pie(j)aka	k ie ( a ) p ie ( j ) a k a	k i ( a ) p i ( j ) a k a
apienie	a p ie n ie	a p i n i
apoie	a p o ie	a p o i
apoie	a p o ie	a p o i
aroekoe(w)a	a r oe k oe ( w ) a	a r u k u ( w ) a
aroekoe(w)a è(a)karoba	a r oe k oe ( w ) a # è ( a ) k a r o b a	a r u k u ( w ) a # ɛ ( a ) k a r o b a
aroeoeieoe(w)a	a r oeoe ie oe ( w ) a	a r u ʔ u i u ( w ) a
awa(h)	a w a ( h )	a w a ( h )
awanaq	a w a n a q	a w a n a ʔ
ba(a)oe(w)a	b a ( a ) oe ( w ) a	b a ( a ) u ( w ) a
baba; oebaba	b a b a ; # oe b a b a	b a b a ; # u b a b a
baba; oebaba	b a b a ; # oe b a b a	b a b a ; # u b a b a
badjoe	b a dj oe	b a d͡ʒ u
bahabaieba	b a h a b a ie b a	b a h a b a i b a
bahora	b a h o r a	b a h o r a
baoe(w)adie	b a oe ( w ) a d ie	b a u ( w ) a d i
barieboerieboe	b a r ie b oe r ie b oe	b a r i b u r i b u
bĕlie(j)oeng	b ĕ l ie ( j ) oe n g	b ə l i ( j ) u n g
bĕnang	b ĕ n a n g	b ə n a n g
biedie	b ie d ie	b i d i
boe	b oe	b u
boe	b oe	b u
boeboeqie	b oe b oe q ie	b u b u ʔ i
boedahiejaq	b oe d a h ie j a q	b u d a h i j a ʔ
boeodo	b oe o d o	b u o d o
boeodo	b oe o d o	b u o d o
dadoe(oe)	d a d oe ( oe )	d a d u ( u )
daiekahadie(j)a	d a ie k a h a d ie ( j ) a	d a i k a h a d i ( j ) a
dajo	d a j o	d a j o
daraqie	d a r a q ie	d a r a ʔ i
dètar	d è t a r	d ɛ t a r
die(j)a	d ie ( j ) a	d i ( j ) a
dja(ä)oe(w)a	dj a ( ä ) oe ( w ) a	d͡ʒ a ( ʔ a ) u ( w ) a
dodo	d o d o	d o d o
dödöhöka	d ö d ö h ö k a	d ɨ d ɨ h ɨ k a
dodokaqäq	d o d o k a qä q	d o d o k a ʔ a ʔ
è	è	ɛ
èa	è a	ɛ a
èa	è a	ɛ a
èaähaie	è a ä h a ie	ɛ a ʔ a h a i
èaä(h)ko	è a ä ( h ) k o	ɛ a ʔ a ( h ) k o
maä(h)ko	m a ä ( h ) k o	m a ʔ a ( h ) k o
èa(ä)haoie	è a ( ä ) h a o ie	ɛ a ( ʔ a ) h a o i
èaäkoe	è a ä k oe	ɛ a ʔ a k u
èaäkoha	è a ä k o h a	ɛ a ʔ a k o h a
èaäoe	è a ä oe	ɛ a ʔ a u
èaäq	è a ä q	ɛ a ʔ a ʔ
èabaä	è a b a ä	ɛ a b a ʔ a
èabaäo	è a b a ä o	ɛ a b a ʔ a o
èabadie(j)o	è a b a d ie ( j ) o	ɛ a b a d i ( j ) o
èabaoekiedaie	è a b a oe k ie d a ie	ɛ a b a u k i d a i
èabaoe(w)a	è a b a oe ( w ) a	ɛ a b a u ( w ) a
èabo	è a b o	ɛ a b o
èaboebaja	è a b oe b a j a	ɛ a b u b a j a
èadahohoe	è a d a h o h oe	ɛ a d a h o h u
èadieho	è a d ie h o	ɛ a d i ç o
èadoe(w)a	è a d oe ( w ) a	ɛ a d u ( w ) a
èadoö(w)ie	è a d o ö ( w ) ie	ɛ a d o ʔ o ( w ) i
èaèkaboe	è a è k a b oe	ɛ a ɛ k a b u
èahabaoeda	è a h a b a oe d a	ɛ a h a b a u d a
èahaboe(w)a	è a h a b oe ( w ) a	ɛ a h a b u ( w ) a
èahaie	è a h a ie	ɛ a h a i
èahaienjoqä	è a h a ie nj o qä	ɛ a h a i ɲ o ʔ a
èahaoedohoie	è a h a oe d o h o ie	ɛ a h a u d o h o i
èahèdie(j)a	è a h è d ie ( j ) a	ɛ a h ɛ d i ( j ) a
èahoepoq	è a h oe p o q	ɛ a h u p o ʔ
èahopè	è a h o p è	ɛ a h o p ɛ
èaie	è a ie	ɛ a i
èajo	è a j o	ɛ a j o
èakakoq	è a k a k o q	ɛ a k a k o ʔ
èanaöa	è a n a ö a	ɛ a n a ʔ o a
èaoeno	è a oe n o	ɛ a u n o
èawieka	è a w ie k a	ɛ a w i k a
èboeboe	è b oe b oe	ɛ b u b u
èhaie(j)oeĕq	è h a ie ( j ) oe ĕ q	ɛ h a i ( j ) u ə ʔ
èhèjog	è h è j o g	ɛ h ɛ j o g
è(j)anoqäq	è ( j ) a n o qä q	ɛ ( j ) a n o ʔ a ʔ
èkabaroekoe	è k a b a r oe k oe	ɛ k a b a r u k u
èkahaie(j)abie	è k a h a ie ( j ) a b ie	ɛ k a h a i ( j ) a b i
èkahoro	è k a h o r o	ɛ k a h o r o
èkaiedodo	è k a ie d o d o	ɛ k a i d o d o
èkapaqie(j)o	è k a p a q ie ( j ) o	ɛ k a p a ʔ i ( j ) o
èkaqoe(w)aie	è k a q oe ( w ) a ie	ɛ k a ʔ u ( w ) a i
èkieoedahjo	è k ie oe d a h j o	ɛ k i u d a h j o
èkieoedie	è k ie oe d ie	ɛ k i u d i
èkietaäpoe(w)aq	è k ie t a ä p oe ( w ) a q	ɛ k i t a ʔ a p u ( w ) a ʔ
èkoe(w)èq	è k oe ( w ) è q	ɛ k u ( w ) ɛ ʔ
èloietjaq	è l o ie tj a q	ɛ l o i t͡ʃ a ʔ
èmoenèqä	è m oe n è qä	ɛ m u n ɛ ʔ a
èokoödoq	è o k o ö d o q	ɛ o k o ʔ o d o ʔ
èpaoe(w)oko	è p a oe ( w ) o k o	ɛ p a u ( w ) o k o
èkanawèq	è k a n a w è q	ɛ k a n a w ɛ ʔ
èkèma	è k è m a	ɛ k ɛ m a
èakadie(j)o	è a k a d ie ( j ) o	ɛ a k a d i ( j ) o
èakaka	è a k a k a	ɛ a k a k a
èakakaie	è a k a k a ie	ɛ a k a k a i
èakano	è a k a n o	ɛ a k a n o
è(a)karoba	è ( a ) k a r o b a	ɛ ( a ) k a r o b a
èakieakie	è a k ie a k ie	ɛ a k i a k i
èakieie	è a k ie ie	ɛ a k i i
èakomaq	è a k o m a q	ɛ a k o m a ʔ
èamaha	è a m a h a	ɛ a m a h a
èamajoq	è a m a j o q	ɛ a m a j o ʔ
èamaniekie	è a m a n ie k ie	ɛ a m a n i k i
èamè	è a m è	ɛ a m ɛ
èamieamie	è a m ie a m ie	ɛ a m i a m i
èana	è a n a	ɛ a n a
èanèka	è a n è k a	ɛ a n ɛ k a
èanèha	è a n è h a	ɛ a n ɛ h a
èanokanie	è a n o k a n ie	ɛ a n o k a n i
èanonöoe	è a n o n ö oe	ɛ a n o n ɨ u
èaoedahohoe	è a oe d a h o h oe	ɛ a u d a h o h u
èaoekaä	è a oe k a ä	ɛ a u k a ʔ a
èaohaq	è a o h a q	ɛ a o h a ʔ
èaokieie	è a o k ie ie	ɛ a o k i i
èapakoe	è a p a k oe	ɛ a p a k u
èapama	è a p a m a	ɛ a p a m a
èapaq	è a p a q	ɛ a p a ʔ
èapara	è a p a r a	ɛ a p a r a
èapo	è a p o	ɛ a p o
èapoe	è a p oe	ɛ a p u
èapoe èkoe(w)o	è a p oe # è k oe ( w ) o	ɛ a p u # ɛ k u ( w ) o
èapoeaka	è a p oe a k a	ɛ a p u a k a
èapoeq	è a p oe q	ɛ a p u ʔ
èapoie	è a p o ie	ɛ a p o i
èa(q)	è a ( q )	ɛ a ( ʔ )
èara	è a r a	ɛ a r a
èara: èhöda	è a r a : # è h ö d a	ɛ a r a : # ɛ h ɨ d a
èmanie	è m a n ie	ɛ m a n i
(oe)èkieho	( oe ) è k ie h o	( u ) ɛ k i ç o
(oe)kieadoboe	( oe ) k ie a d o b oe	( u ) k i a d o b u
(oe)wabèha	( oe ) w a b è h a	( u ) w a b ɛ h a
(oe)äie	( oe ) ä ie	( u ) ʔ a i
(oe)apo	( oe ) a p o	( u ) a p o
baära	b a ä r a	b a ʔ a r a
èaraboeka	è a r a b oe k a	ɛ a r a b u k a
èaraqko(w)a	è a r a q k o ( w ) a	ɛ a r a ʔ k o ( w ) a
èaroekèrè	è a r oe k è r è	ɛ a r u k ɛ r ɛ
èaroe(w)a	è a r oe ( w ) a	ɛ a r u ( w ) a
èaroja	è a r o j a	ɛ a r o j a
èaropa	è a r o p a	ɛ a r o p a
èaroqä	è a r o qä	ɛ a r o ʔ a
èatjara	è a tj a r a	ɛ a t͡ʃ a r a
èawaq	è a w a q	ɛ a w a ʔ
èba	è b a	ɛ b a
èbaba	è b a b a	ɛ b a b a
èbadjiedjo	è b a dj ie dj o	ɛ b a d͡ʒ i d͡ʒ o
èbaho	è b a h o	ɛ b a h o
èbaie	è b a ie	ɛ b a i
èbaka	è b a k a	ɛ b a k a
èbaka: (è)oewè	è b a k a : # ( è ) oe w è	ɛ b a k a : # ( ɛ ) u w ɛ
(oe)kahaoq	( oe ) k a h a o q	( u ) k a h a o ʔ
(oe)kiedjaie	( oe ) k ie dj a ie	( u ) k i d͡ʒ a i
(oe)kokoq	( oe ) k o k o q	( u ) k o k o ʔ
(oe)oemo	( oe ) oe m o	( u ) u m o
èbaoe	è b a oe	ɛ b a u
èbèlo(w)a	è b è l o ( w ) a	ɛ b ɛ l o ( w ) a
èbèo	è b è o	ɛ b ɛ o
èbiehoe	è b ie h oe	ɛ b i ç u
èbie(j)oe	è b ie ( j ) oe	ɛ b i ( j ) u
èbo	è b o	ɛ b o
èboeèparaqwo	è b oe è p a r a q w o	ɛ b u ɛ p a r a ʔ w o
èboe(w)è	è b oe ( w ) è	ɛ b u ( w ) ɛ
èboqaboqa	è b o q a b o q a	ɛ b o ʔ a b o ʔ a
èdaba	è d a b a	ɛ d a b a
èdaboeho	è d a b oe h o	ɛ d a b u h o
èdaboeho	è d a b oe h o	ɛ d a b u h o
èadoho	è a d o h o	ɛ a d o h o
èaroiepoko	è a r o ie p o k o	ɛ a r o i p o k o
èbaka	è b a k a	ɛ b a k a
èie(j)oeh	è ie ( j ) oe h	ɛ i ( j ) u h
èkarèpè(h)	è k a r è p è ( h )	ɛ k a r ɛ p ɛ ( h )
èkiedjaie	è k ie dj a ie	ɛ k i d͡ʒ a i
èoedoe	è oe d oe	ɛ u d u
èoekaq	è oe k a q	ɛ u k a ʔ
èpaö	è p a ö	ɛ p a ʔ o
èdado; èdadoèoedoe	è d a d o ; # è d a d oè oe d oe	ɛ d a d o ; # ɛ d a d u u d u
èdahajo	è d a h a j o	ɛ d a h a j o
èdahèboeäo	è d a h è b oe ä o	ɛ d a h ɛ b u ʔ a o
èdakohaq	è d a k o h a q	ɛ d a k o h a ʔ
èdèabo	è d è a b o	ɛ d ɛ a b o
èdiehao	è d ie h a o	ɛ d i ç a o
èdiehie(j)oq	è d ie h ie ( j ) o q	ɛ d i ç i ( j ) o ʔ
èdieho	è d ie h o	ɛ d i ç o
èdie(j)a	è d ie ( j ) a	ɛ d i ( j ) a
èdie(j)o	è d ie ( j ) o	ɛ d i ( j ) o
èdieie(j)o	è d ie ie ( j ) o	ɛ d i i ( j ) o
èdie(j)oe(w)aka	è d ie ( j ) oe ( w ) a k a	ɛ d i ( j ) u ( w ) a k a
èdie(j)oewaoekèdjajoe	è d ie ( j ) oe w a oe k è dj a j oe	ɛ d i ( j ) u w a u k ɛ d͡ʒ a j u
èdiekieho	è d ie k ie h o	ɛ d i k i ç o
èdiekoeroe	è d ie k oe r oe	ɛ d i k u r u
èdieoboe; èdieoboedie(j)ĕ	è d ie o b oe ; # è d ie o b oe d ie ( j ) ĕ	ɛ d i o b u ; # ɛ d i o b u d i ( j ) ə
èdoboe	è d o b oe	ɛ d o b u
èdoboe kanapoe(w)a	è d o b oe # k a n a p oe ( w ) a	ɛ d o b u # k a n a p u ( w ) a
èdodie	è d o d ie	ɛ d o d i
èdoehoekie(j)aq	è d oe h oe k ie ( j ) a q	ɛ d u h u k i ( j ) a ʔ
èdohaie	è d o h a ie	ɛ d o h a i
èdohoie	è d o h o ie	ɛ d o h o i
kiedohoie	k ie d o h o ie	k i d o h o i
èdolèdolè	è d o l è d o l è	ɛ d o l ɛ d o l ɛ
èdoöa	è d o ö a	ɛ d o ʔ o a
èdoöraoe	è d o ö r a oe	ɛ d o ʔ o r a u
èdopo	è d o p o	ɛ d o p o
èdopodopo	è d o p o d o p o	ɛ d o p o d o p o
èdoro	è d o r o	ɛ d o r o
èè	è è	ɛ ɛ
èèbaè	è è b a è	ɛ ɛ b a ɛ
èèdako	è è d a k o	ɛ ɛ d a k o
èèèno	è è è n o	ɛ ɛ ɛ n o
èèhè	è è h è	ɛ ɛ h ɛ
èèho	è è h o	ɛ ɛ h o
èèhöa	è è h ö a	ɛ ɛ h ɨ a
èè(j)aq	è è ( j ) a q	ɛ ɛ ( j ) a ʔ
èèkadjie(j)a	è è k a dj ie ( j ) a	ɛ ɛ k a d͡ʒ i ( j ) a
èèko	è è k o	ɛ ɛ k o
èèlo	è è l o	ɛ ɛ l o
èèmaha	è è m a h a	ɛ ɛ m a h a
èèna	è è n a	ɛ ɛ n a
èènèho	è è n è h o	ɛ ɛ n ɛ h o
èènono; èènono: oepo	è è n o n o ; # è è n o n o : # oe p o	ɛ ɛ n o n o ; # ɛ ɛ n o n o : # u p o
oeèpo	oe è p o	u ɛ p o
èèodie	è è o d ie	ɛ ɛ o d i
èèodieoekoewo	è è o d ie oe k oe w o	ɛ ɛ o d i u k u w o
èèoq	è è o q	ɛ ɛ o ʔ
èèpè	è è p è	ɛ ɛ p ɛ
èèpo	è è p o	ɛ ɛ p o
èhabarie(j)a	è h a b a r ie ( j ) a	ɛ h a b a r i ( j ) a
èhado(q)	è h a d o ( q )	ɛ h a d o ( ʔ )
èhahadiediekie	è h a h a d ie d ie k ie	ɛ h a h a d i d i k i
èhaiepoe	è h a ie p oe	ɛ h a i p u
èhamo	è h a m o	ɛ h a m o
kiehahamo	k ie h a h a m o	k i ç a h a m o
èhamoa	è h a m o a	ɛ h a m o a
èhanoe(w)a	è h a n oe ( w ) a	ɛ h a n u ( w ) a
èhao	è h a o	ɛ h a o
èharobèao	è h a r o b è a o	ɛ h a r o b ɛ a o
èharoeq	è h a r oe q	ɛ h a r u ʔ
èhèapo	è h è a p o	ɛ h ɛ a p o
èhèboe	è h è b oe	ɛ h ɛ b u
èhèie(j)o	è h è ie ( j ) o	ɛ h ɛ i ( j ) o
èhèja	è h è j a	ɛ h ɛ j a
èhèkoe(q)	è h è k oe ( q )	ɛ h ɛ k u ( ʔ )
mahèkoe(q)	m a h è k oe ( q )	m a h ɛ k u ( ʔ )
èhèkoe(q)wa	è h è k oe ( q ) w a	ɛ h ɛ k u ( ʔ ) w a
èhèla	è h è l a	ɛ h ɛ l a
kèo hèla	k è o # h è l a	k ɛ o # h ɛ l a
èhèoe(w)a	è h è oe ( w ) a	ɛ h ɛ u ( w ) a
èhèoe(w)è	è h è oe ( w ) è	ɛ h ɛ u ( w ) ɛ
èhè(q)ie(j)oe	è h è ( q ) ie ( j ) oe	ɛ h ɛ ( ʔ ) i ( j ) u
èhèrie(j)a	è h è r ie ( j ) a	ɛ h ɛ r i ( j ) a
èhie(j)o	è h ie ( j ) o	ɛ h i ( j ) o
èhoa	è h o a	ɛ h o a
èhöadie	è h ö a d ie	ɛ h ɨ a d i
mahöadie	m a h ö a d ie	m a h ɨ a d i
èhoanie	è h o a n ie	ɛ h o a n i
èho(w)apo	è h o ( w ) a p o	ɛ h o ( w ) a p o
èhoboe	è h o b oe	ɛ h o b u
èhöda	è h ö d a	ɛ h ɨ d a
èhoekoe	è h oe k oe	ɛ h u k u
èhoe(w)a	è h oe ( w ) a	ɛ h u ( w ) a
èhoka	è h o k a	ɛ h o k a
èhokaie	è h o k a ie	ɛ h o k a i
èhoka(q)	è h o k a ( q )	ɛ h o k a ( ʔ )
èhokoe	è h o k oe	ɛ h o k u
èhopo	è h o p o	ɛ h o p o
èhoqä	è h o qä	ɛ h o ʔ a
èhora	è h o r a	ɛ h o r a
èhowaie	è h o w a ie	ɛ h o w a i
èie	è ie	ɛ i
èieboe	è ie b oe	ɛ i b u
èiedjie	è ie dj ie	ɛ i d͡ʒ i
aiedjie	a ie dj ie	a i d͡ʒ i
èieha	è ie h a	ɛ i ç a
èieie	è ie ie	ɛ i i
èieieoedoe	è ie ie oe d oe	ɛ i i u d u
èie(j)aoe	è ie ( j ) a oe	ɛ i ( j ) a u
èie(j)ĕ	è ie ( j ) ĕ	ɛ i ( j ) ə
èie(j)oba	è ie ( j ) o b a	ɛ i ( j ) o b a
èie(j)oedopo	è ie ( j ) oe d o p o	ɛ i ( j ) u d o p o
èie(j)oöboöie	è ie ( j ) o ö b o ö ie	ɛ i ( j ) o ʔ o b o ʔ o i
èienoeqoe(q)	è ie n oe q oe ( q )	ɛ i n u ʔ u ( ʔ )
èienoeqoeie	è ie n oe q oe ie	ɛ i n u ʔ u i
èiepo	è ie p o	ɛ i p o
èietjo	è ie tj o	ɛ i t͡ʃ o
è(j)adamaie	è ( j ) a d a m a ie	ɛ ( j ) a d a m a i
è(j)aha	è ( j ) a h a	ɛ ( j ) a h a
è(j)ahakoqie	è ( j ) a h a k o q ie	ɛ ( j ) a h a k o ʔ i
è(j)ahaoeobie	è ( j ) a h a oe o b ie	ɛ ( j ) a h a u o b i
è(j)ahèaqaq	è ( j ) a h è a q a q	ɛ ( j ) a h ɛ a ʔ a ʔ
è(j)akoqä	è ( j ) a k o qä	ɛ ( j ) a k o ʔ a
è(j)akoro(w)a	è ( j ) a k o r o ( w ) a	ɛ ( j ) a k o r o ( w ) a
è(j)aniemaie	è ( j ) a n ie m a ie	ɛ ( j ) a n i m a i
è(j)aqètoka	è ( j ) a q è t o k a	ɛ ( j ) a ʔ ɛ t o k a
è(j)araq	è ( j ) a r a q	ɛ ( j ) a r a ʔ
è(j)araq noeha	è ( j ) a r a q # n oe h a	ɛ ( j ) a r a ʔ # n u h a
è(j)obie	è ( j ) o b ie	ɛ ( j ) o b i
ĕ(j)opoko	ĕ ( j ) o p o k o	ə ( j ) o p o k o
èkaä	è k a ä	ɛ k a ʔ a
èkabaiedoq	è k a b a ie d o q	ɛ k a b a i d o ʔ
èkabaieka	è k a b a ie k a	ɛ k a b a i k a
èkabakè	è k a b a k è	ɛ k a b a k ɛ
èkabakèka	è k a b a k è k a	ɛ k a b a k ɛ k a
èkaboeäjo	è k a b oe ä j o	ɛ k a b u ʔ a j o
èkadaboeqä	è k a d a b oe qä	ɛ k a d a b u ʔ a
èkadaha(q)	è k a d a h a ( q )	ɛ k a d a h a ( ʔ )
èkadieodie	è k a d ie o d ie	ɛ k a d i o d i
èkadieopè	è k a d ie o p è	ɛ k a d i o p ɛ
èkadodo(q)	è k a d o d o ( q )	ɛ k a d o d o ( ʔ )
èkaèn	è k a è n	ɛ k a ɛ n
èkaha	è k a h a	ɛ k a h a
èkahaba	è k a h a b a	ɛ k a h a b a
èkahaèpie	è k a h a è p ie	ɛ k a h a ɛ p i
(è)kahaèq	( è ) k a h a è q	( ɛ ) k a h a ɛ ʔ
èkahanoa	è k a h a n o a	ɛ k a h a n o a
èkahaö	è k a h a ö	ɛ k a h a ʔ o
èkahaoe	è k a h a oe	ɛ k a h a u
èkahaoekoe	è k a h a oe k oe	ɛ k a h a u k u
èkahaoq	è k a h a o q	ɛ k a h a o ʔ
èkahi(j)oe	è k a h i ( j ) oe	ɛ k a h i ( j ) u
èkahieno(a)	è k a h ie n o ( a )	ɛ k a h i n o ( a )
èkahoe(w)èqo	è k a h oe ( w ) è q o	ɛ k a h u ( w ) ɛ ʔ o
èkaie	è k a ie	ɛ k a i
èkaieno(h)	è k a ie n o ( h )	ɛ k a i n o ( h )
èkaie(oe)dahoe(hoe)	è k a ie ( oe ) d a h oe ( h oe )	ɛ k a i ( u ) d a h u ( h u )
èkajoqpèdjie	è k a j o q p è dj ie	ɛ k a j o ʔ p ɛ d͡ʒ i
èkakorèie(j)o	è k a k o r è ie ( j ) o	ɛ k a k o r ɛ i ( j ) o
èkakorè(j)o	è k a k o r è ( j ) o	ɛ k a k o r ɛ ( j ) o
èkamie(j)oe	è k a m ie ( j ) oe	ɛ k a m i ( j ) u
èkanaja	è k a n a j a	ɛ k a n a j a
èkanjoq	è k a nj o q	ɛ k a ɲ o ʔ
èkanoa	è k a n o a	ɛ k a n o a
èkanoaie	è k a n o a ie	ɛ k a n o a i
èkanoeoenoe	è k a n oeoe n oe	ɛ k a n u ʔ u n u
èk(a)oeqpanoe	è k ( a ) oe q p a n oe	ɛ k ( a ) u ʔ p a n u
èkaoe(w)a	è k a oe ( w ) a	ɛ k a u ( w ) a
èkapahoeka	è k a p a h oe k a	ɛ k a p a h u k a
èkapèlo	è k a p è l o	ɛ k a p ɛ l o
èkapoeh	è k a p oe h	ɛ k a p u h
èka(q)ka(q)	è k a ( q ) k a ( q )	ɛ k a ( ʔ ) k a ( ʔ )
èkaraoe(w)ahè	è k a r a oe ( w ) a h è	ɛ k a r a u ( w ) a h ɛ
èkarèpè	è k a r è p è	ɛ k a r ɛ p ɛ
èkarara	è k a r a r a	ɛ k a r a r a
èkarieha	è k a r ie h a	ɛ k a r i ç a
èkarieha oe(w)apo	è k a r ie h a # oe ( w ) a p o	ɛ k a r i ç a # u ( w ) a p o
oe(w)aie	oe ( w ) a ie	u ( w ) a i
èkèè	è k è è	ɛ k ɛ ɛ
èkèèpa	è k è è p a	ɛ k ɛ ɛ p a
kieèèpa	k ie è è p a	k i ɛ ɛ p a
èkèh(è)	è k è h ( è )	ɛ k ɛ h ( ɛ )
èkèhèodo	è k è h è o d o	ɛ k ɛ h ɛ o d o
èkèkong	è k è k o n g	ɛ k ɛ k o n g
èkèma	è k è m a	ɛ k ɛ m a
èkèoäh	è k è o ä h	ɛ k ɛ o ʔ a h
èkèoq	è k è o q	ɛ k ɛ o ʔ
èkèponie	è k è p o n ie	ɛ k ɛ p o n i
èkieakie	è k ie a k ie	ɛ k i a k i
èkieakoqä	è k ie a k o qä	ɛ k i a k o ʔ a
èkieapo	è k ie a p o	ɛ k i a p o
èkiedapè(j)a	è k ie d a p è ( j ) a	ɛ k i d a p ɛ ( j ) a
èkiediebèie(j)oq	è k ie d ie b è ie ( j ) o q	ɛ k i d i b ɛ i ( j ) o ʔ
èkiedjaie	è k ie dj a ie	ɛ k i d͡ʒ a i
èkiedjè	è k ie dj è	ɛ k i d͡ʒ ɛ
èkiedjiekiedjie	è k ie dj ie k ie dj ie	ɛ k i d͡ʒ i k i d͡ʒ i
èkieèèo	è k ie è è o	ɛ k i ɛ ɛ o
ékiehie	é k ie h ie	e k i ç i
èkiehie(j)oedo	è k ie h ie ( j ) oe d o	ɛ k i ç i ( j ) u d o
èkieho	è k ie h o	ɛ k i ç o
èkiehöa	è k ie h ö a	ɛ k i ç ɨ a
èkiehoedo	è k ie h oe d o	ɛ k i ç u d o
èkiehoedo	è k ie h oe d o	ɛ k i ç u d o
èkiehohè(j)a	è k ie h o h è ( j ) a	ɛ k i ç o h ɛ ( j ) a
èieha kiehohè(j)a die(j)a	è ie h a # k ie h o h è ( j ) a # d ie ( j ) a	ɛ i ç a # k i ç o h ɛ ( j ) a # d i ( j ) a
èkieie	è k ie ie	ɛ k i i
èkieie(j)o	è k ie ie ( j ) o	ɛ k i i ( j ) o
èkieie(j)ahaq	è k ie ie ( j ) a h a q	ɛ k i i ( j ) a h a ʔ
èkie(j)aö	è k ie ( j ) a ö	ɛ k i ( j ) a ʔ o
èkie(j)oe	è k ie ( j ) oe	ɛ k i ( j ) u
èkie(j)oeqie	è k ie ( j ) oe q ie	ɛ k i ( j ) u ʔ i
èkieka	è k ie k a	ɛ k i k a
èkiekie	è k ie k ie	ɛ k i k i
èkiekohaq	è k ie k o h a q	ɛ k i k o h a ʔ
èkiemo	è k ie m o	ɛ k i m o
èkiemo	è k ie m o	ɛ k i m o
èkienono	è k ie n o n o	ɛ k i n o n o
èkieodoha	è k ie o d o h a	ɛ k i o d o h a
èkietjaho	è k ie tj a h o	ɛ k i t͡ʃ a h o
èkietjoh	è k ie tj o h	ɛ k i t͡ʃ o h
èkietohè	è k ie t o h è	ɛ k i t o h ɛ
èkoanoe	è k o a n oe	ɛ k o a n u
èköaq	è k ö a q	ɛ k ɨ a ʔ
èkodie(j)o	è k o d ie ( j ) o	ɛ k o d i ( j ) o
èkodaäjo	è k o d a ä j o	ɛ k o d a ʔ a j o
èkoeaka	è k oe a k a	ɛ k u a k a
èkoedodo	è k oe d o d o	ɛ k u d o d o
èkoedodoka	è k oe d o d o k a	ɛ k u d o d o k a
èkoeha	è k oe h a	ɛ k u h a
èkoehie(j)o	è k oe h ie ( j ) o	ɛ k u h i ( j ) o
èkoeka	è k oe k a	ɛ k u k a
èkoeka(oe)waie	è k oe k a ( oe ) w a ie	ɛ k u k a ( u ) w a i
èkoema(q)aoe	è k oe m a ( q ) a oe	ɛ k u m a ( ʔ ) a u
èkoena	è k oe n a	ɛ k u n a
èkoeöedo	è k oe ö e d o	ɛ k u ʔ o e d o
èkoepado	è k oe p a d o	ɛ k u p a d o
èkoe(w)abo	è k oe ( w ) a b o	ɛ k u ( w ) a b o
èkoe(w)iekoe(w)ie	è k oe ( w ) ie k oe ( w ) ie	ɛ k u ( w ) i k u ( w ) i
èkoe(w)o	è k oe ( w ) o	ɛ k u ( w ) o
èkohèaq	è k o h è a q	ɛ k o h ɛ a ʔ
èkoh(oie)	è k o h ( o ie )	ɛ k o h ( o i )
èkohoq	è k o h o q	ɛ k o h o ʔ
èkohoqoe(j)obie	è k o h o q oe ( j ) o b ie	ɛ k o h o ʔ u ( j ) o b i
èkojoq	è k o j o q	ɛ k o j o ʔ
èkokoq	è k o k o q	ɛ k o k o ʔ
èkonienie	è k o n ie n ie	ɛ k o n i n i
kokonienie	k o k o n ie n ie	k o k o n i n i
èkonjoq	è k o nj o q	ɛ k o ɲ o ʔ
èkoq	è k o q	ɛ k o ʔ
èkoqä	è k o qä	ɛ k o ʔ a
èkoqa(j)odie(j)a	è k o q a ( j ) o d ie ( j ) a	ɛ k o ʔ a ( j ) o d i ( j ) a
èko(q)hajo	è k o ( q ) h a j o	ɛ k o ( ʔ ) h a j o
èko(ö)qko(ö)q	è k o ( ö ) q k o ( ö ) q	ɛ k o ( ʔ o ) ʔ k o ( ʔ o ) ʔ
èkoq(n)jaoe	è k o q ( n ) j a oe	ɛ k o ʔ ( n ) j a u
èkoqoeie	è k o q oe ie	ɛ k o ʔ u i
èkoropie	è k o r o p ie	ɛ k o r o p i
èko(w)a	è k o ( w ) a	ɛ k o ( w ) a
èko(w)èq	è k o ( w ) è q	ɛ k o ( w ) ɛ ʔ
èko(w)èq	è k o ( w ) è q	ɛ k o ( w ) ɛ ʔ
èoe(w)è	è oe ( w ) è	ɛ u ( w ) ɛ
ie(j)akapieta	ie ( j ) a k a p ie t a	i ( j ) a k a p i t a
kaoedara	k a oe d a r a	k a u d a r a
oehoeqkoe(w)o	oe h oe q k oe ( w ) o	u h u ʔ k u ( w ) o
oewokie	oe w o k ie	u w o k i
èko(w)èq	è k o ( w ) è q	ɛ k o ( w ) ɛ ʔ
èlaäpoe(w)a	è l a ä p oe ( w ) a	ɛ l a ʔ a p u ( w ) a
èlahaö	è l a h a ö	ɛ l a h a ʔ o
èmanie	è m a n ie	ɛ m a n i
èlaohoe	è l a o h oe	ɛ l a o h u
èlè	è l è	ɛ l ɛ
èlèaq	è l è a q	ɛ l ɛ a ʔ
èloaba	è l o a b a	ɛ l o a b a
èloha	è l o h a	ɛ l o h a
èmahokakie	è m a h o k a k ie	ɛ m a h o k a k i
èmanie	è m a n ie	ɛ m a n i
èmènahoa	è m è n a h o a	ɛ m ɛ n a h o a
èmèno	è m è n o	ɛ m ɛ n o
èmèo	è m è o	ɛ m ɛ o
èmienoemienoe	è m ie n oe m ie n oe	ɛ m i n u m i n u
èmoamoq	è m o a m o q	ɛ m o a m o ʔ
èmoeoeha	è m oeoe h a	ɛ m u ʔ u h a
èmomoq	è m o m o q	ɛ m o m o ʔ
èmoöie(j)a	è m o ö ie ( j ) a	ɛ m o ʔ o i ( j ) a
ènaè(na)	è n a è ( n a )	ɛ n a ɛ ( n a )
ènaè(na): oe(w)apo	è n a è ( n a ) : # oe ( w ) a p o	ɛ n a ɛ ( n a ) : # u ( w ) a p o
oe(w)aie	oe ( w ) a ie	u ( w ) a i
ènana	è n a n a	ɛ n a n a
ènanaoe(w)è	è n a n a oe ( w ) è	ɛ n a n a u ( w ) ɛ
ènapa	è n a p a	ɛ n a p a
ènapienapie	è n a p ie n a p ie	ɛ n a p i n a p i
ènapienie	è n a p ie n ie	ɛ n a p i n i
ènè	è n è	ɛ n ɛ
ènèhèie	è n è h è ie	ɛ n ɛ h ɛ i
ènèanèa	è n è a n è a	ɛ n ɛ a n ɛ a
ènèka	è n è k a	ɛ n ɛ k a
ènieènie(j)a	è n ie è n ie ( j ) a	ɛ n i ɛ n i ( j ) a
ènie(j)o	è n ie ( j ) o	ɛ n i ( j ) o
ènienie	è n ie n ie	ɛ n i n i
ènoä	è n o ä	ɛ n o ʔ a
ènoeqoeq	è n oe q oe q	ɛ n u ʔ u ʔ
ènohaie	è n o h a ie	ɛ n o h a i
ènomonomo	è n o m o n o m o	ɛ n o m o n o m o
ènoöhoq	è n o ö h o q	ɛ n o ʔ o h o ʔ
èoaba	è o a b a	ɛ o a b a
èobo	è o b o	ɛ o b o
èodie	è o d ie	ɛ o d i
apieha èodiedie(j)a	a p ie h a # è o d ie d ie ( j ) a	a p i ç a # ɛ o d i d i ( j ) a
èodieaäq	è o d ie a ä q	ɛ o d i a ʔ a ʔ
bodieaäq	b o d ie a ä q	b o d i a ʔ a ʔ
kahohodieaäq	k a h o h o d ie a ä q	k a h o h o d i a ʔ a ʔ
èodieöka	è o d ie ö k a	ɛ o d i ʔ o k a
èodjie	è o dj ie	ɛ o d͡ʒ i
èodo	è o d o	ɛ o d o
èodöda	è o d ö d a	ɛ o d ɨ d a
èodoe	è o d oe	ɛ o d u
èodohèie	è o d o h è ie	ɛ o d o h ɛ i
èoeba	è oe b a	ɛ u b a
èoeba: èkaèn	è oe b a : # è k a è n	ɛ u b a : # ɛ k a ɛ n
èkieadoboe	è k ie a d o b oe	ɛ k i a d o b u
èkojoq	è k o j o q	ɛ k o j o ʔ
ètèbè	è t è b è	ɛ t ɛ b ɛ
kèèèpa	k è è è p a	k ɛ ɛ ɛ p a
èoeda	è oe d a	ɛ u d a
èoedie	è oe d ie	ɛ u d i
èoedoe	è oe d oe	ɛ u d u
èoedoe bèlo(w)a	è oe d oe # b è l o ( w ) a	ɛ u d u # b ɛ l o ( w ) a
èoeèhè(j)a	è oe è h è ( j ) a	ɛ u ɛ h ɛ ( j ) a
èoehoe	è oe h oe	ɛ u h u
èoeko	è oe k o	ɛ u k o
èoekoe	è oe k oe	ɛ u k u
èoekoeaie	è oe k oe a ie	ɛ u k u a i
èoekoediepo	è oe k oe d ie p o	ɛ u k u d i p o
èoekoeie	è oe k oe ie	ɛ u k u i
èoekoeqoe	è oe k oe q oe	ɛ u k u ʔ u
èoekoe(w)aie	è oe k oe ( w ) a ie	ɛ u k u ( w ) a i
èoema	è oe m a	ɛ u m a
èoemiehie	è oe m ie h ie	ɛ u m i ç i
èoemo	è oe m o	ɛ u m o
èoenèkè	è oe n è k è	ɛ u n ɛ k ɛ
è(oe)noekie(j)o	è ( oe ) n oe k ie ( j ) o	ɛ ( u ) n u k i ( j ) o
èoeoe	è oeoe	ɛ u ʔ u
èoeoe(w)apo	è oeoe ( w ) a p o	ɛ u ʔ u ( w ) a p o
èoeoenoe	è oeoe n oe	ɛ u ʔ u n u
èoepo	è oe p o	ɛ u p o
èoepoeie(j)o	è oe p oe ie ( j ) o	ɛ u p u i ( j ) o
èoepoeqoe(w)o	è oe p oe q oe ( w ) o	ɛ u p u ʔ u ( w ) o
èoepoe(w)a	è oe p oe ( w ) a	ɛ u p u ( w ) a
èoe(w)a	è oe ( w ) a	ɛ u ( w ) a
èoe(w)aie	è oe ( w ) a ie	ɛ u ( w ) a i
èoe(w)aka	è oe ( w ) a k a	ɛ u ( w ) a k a
èoe(w)apo	è oe ( w ) a p o	ɛ u ( w ) a p o
èoe(w)oho	è oe ( w ) o h o	ɛ u ( w ) o h o
è(o)hora; è(o)horaoekèèpa	è ( o ) h o r a ; # è ( o ) h o r a oe k è è p a	ɛ ( o ) h o r a ; # ɛ ( o ) h o r a u k ɛ ɛ p a
èokaha	è o k a h a	ɛ o k a h a
èokahao	è o k a h a o	ɛ o k a h a o
èokaq	è o k a q	ɛ o k a ʔ
èokie(j)o	è o k ie ( j ) o	ɛ o k i ( j ) o
èoko	è o k o	ɛ o k o
èokoa	è o k o a	ɛ o k o a
èoko(ĕ)	è o k o ( ĕ )	ɛ o k o ( ə )
èokoeh; èokoehèoedoe	è o k oe h ; # è o k oe h è oe d oe	ɛ o k u h ; # ɛ o k u h ɛ u d u
èokohè	è o k o h è	ɛ o k o h ɛ
èokomè	è o k o m è	ɛ o k o m ɛ
èokopie	è o k o p ie	ɛ o k o p i
èokoq	è o k o q	ɛ o k o ʔ
èomo(kie)	è o m o ( k ie )	ɛ o m o ( k i )
èomohoĕ	è o m o h o ĕ	ɛ o m o h o ə
èomona	è o m o n a	ɛ o m o n a
èomoqö	è o m o q ö	ɛ o m o ʔ ɨ
èonokĕ	è o n o k ĕ	ɛ o n o k ə
èononie	è o n o n ie	ɛ o n o n i
èoöbaq	è o ö b a q	ɛ o ʔ o b a ʔ
èoöbo	è o ö b o	ɛ o ʔ o b o
èoöboq	è o ö b o q	ɛ o ʔ o b o ʔ
èoökie	è o ö k ie	ɛ o ʔ o k i
èopa	è o p a	ɛ o p a
èopoe	è o p oe	ɛ o p u
èoqoe	è o q oe	ɛ o ʔ u
èoqoq	è o q o q	ɛ o ʔ o ʔ
èoqoqie	è o q o q ie	ɛ o ʔ o ʔ i
èoraie	è o r a ie	ɛ o r a i
èpa	è p a	ɛ p a
èpa(ä)hona	è p a ( ä ) h o n a	ɛ p a ( ʔ a ) h o n a
èpaäno	è p a ä n o	ɛ p a ʔ a n o
èpaäo	è p a ä o	ɛ p a ʔ a o
èpaboriekie	è p a b o r ie k ie	ɛ p a b o r i k i
èpadoedoe	è p a d oe d oe	ɛ p a d u d u
èpaèka	è p a è k a	ɛ p a ɛ k a
èpaèloèpaèloie	è p a è l oè p a è l o ie	ɛ p a ɛ l u p a ɛ l o i
èpaènoqjaqä	è p a è n o q j a qä	ɛ p a ɛ n o ʔ j a ʔ a
èpaèpa	è p a è p a	ɛ p a ɛ p a
èpahiedoa	è p a h ie d o a	ɛ p a h i d o a
èpahjoe	è p a h j oe	ɛ p a h j u
èèdako	è è d a k o	ɛ ɛ d a k o
èpaho	è p a h o	ɛ p a h o
èpahoäq	è p a h o ä q	ɛ p a h o ʔ a ʔ
èpahoe(w)a	è p a h oe ( w ) a	ɛ p a h u ( w ) a
èpaienoä	è p a ie n o ä	ɛ p a i n o ʔ a
èpaka	è p a k a	ɛ p a k a
èpakamaie	è p a k a m a ie	ɛ p a k a m a i
èpakèlie	è p a k è l ie	ɛ p a k ɛ l i
èpakoehè	è p a k oe h è	ɛ p a k u h ɛ
èpakoeie	è p a k oe ie	ɛ p a k u i
èpako(w)a	è p a k o ( w ) a	ɛ p a k o ( w ) a
èpalè	è p a l è	ɛ p a l ɛ
èpananaö	è p a n a n a ö	ɛ p a n a n a ʔ o
èpanoe	è p a n oe	ɛ p a n u
èpanoeka	è p a n oe k a	ɛ p a n u k a
èpanèma	è p a n è m a	ɛ p a n ɛ m a
èpaö	è p a ö	ɛ p a ʔ o
èpaopa	è p a o p a	ɛ p a o p a
èpaoqöqaie	è p a o q ö q a ie	ɛ p a o ʔ ɨ ʔ a i
èpè	è p è	ɛ p ɛ
èpèa	è p è a	ɛ p ɛ a
èpèa(ie)ha	è p è a ( ie ) h a	ɛ p ɛ a ( i ) h a
èpèdjie	è p è dj ie	ɛ p ɛ d͡ʒ i
èpèdjiekèèqbara	è p è dj ie k è è q b a r a	ɛ p ɛ d͡ʒ i k ɛ ɛ ʔ b a r a
èpèdo(w)a(ö)	è p è d o ( w ) a ( ö )	ɛ p ɛ d o ( w ) a ( ʔ o )
èpèhè	è p è h è	ɛ p ɛ h ɛ
èpèkoe(w)aq	è p è k oe ( w ) a q	ɛ p ɛ k u ( w ) a ʔ
èpèkoeqwaq	è p è k oe q w a q	ɛ p ɛ k u ʔ w a ʔ
èpènaö	è p è n a ö	ɛ p ɛ n a ʔ o
èpèrhaoedie	è p è r h a oe d ie	ɛ p ɛ r h a u d i
èpèrie(j)oq	è p è r ie ( j ) o q	ɛ p ɛ r i ( j ) o ʔ
èpieako(w)èq	è p ie a k o ( w ) è q	ɛ p i a k o ( w ) ɛ ʔ
èpieaoe(w)apo	è p ie a oe ( w ) a p o	ɛ p i a u ( w ) a p o
èpiedjaja	è p ie dj a j a	ɛ p i d͡ʒ a j a
èpiedjoe	è p ie dj oe	ɛ p i d͡ʒ u
èpiedjoeapo	è p ie dj oe a p o	ɛ p i d͡ʒ u a p o
èpieho; èpiehooe(è)oe(w)è	è p ie h o ; # è p ie h o oe ( è ) oe ( w ) è	ɛ p i ç o ; # ɛ p i ç o u ( ɛ ) u ( w ) ɛ
èpie(j)a	è p ie ( j ) a	ɛ p i ( j ) a
èpie(j)opie(j)o	è p ie ( j ) o p ie ( j ) o	ɛ p i ( j ) o p i ( j ) o
èpieko	è p ie k o	ɛ p i k o
èpienie	è p ie n ie	ɛ p i n i
èpieniepie	è p ie n ie p ie	ɛ p i n i p i
èpiepie	è p ie p ie	ɛ p i p i
èpoäq	è p o ä q	ɛ p o ʔ a ʔ
èpoeäo	è p oe ä o	ɛ p u ʔ a o
èpoedarie	è p oe d a r ie	ɛ p u d a r i
èpoedoe	è p oe d oe	ɛ p u d u
èpoeha	è p oe h a	ɛ p u h a
èpoeiehoe	è p oe ie h oe	ɛ p u i ç u
èpoeko	è p oe k o	ɛ p u k o
èpoenoe	è p oe n oe	ɛ p u n u
èpoeoe	è p oeoe	ɛ p u ʔ u
èpoe(oe)qoe	è p oe ( oe ) q oe	ɛ p u ( u ) ʔ u
èpoe(oe)qoe: oe(w)apo	è p oe ( oe ) q oe : # oe ( w ) a p o	ɛ p u ( u ) ʔ u : # u ( w ) a p o
oe(w)aie	oe ( w ) a ie	u ( w ) a i
èpoeroedoe(ie)	è p oe r oe d oe ( ie )	ɛ p u r u d u ( i )
èpoeroedoe(ie): èoedoe	è p oe r oe d oe ( ie ) : # è oe d oe	ɛ p u r u d u ( i ) : # ɛ u d u
oebaka	oe b a k a	u b a k a
èpoeroedoe(ie)	è p oe r oe d oe ( ie )	ɛ p u r u d u ( i )
èpoeroedoe(ie): aniemaie	è p oe r oe d oe ( ie ) : # a n ie m a ie	ɛ p u r u d u ( i ) : # a n i m a i
èko(ö)qko(ö)q	è k o ( ö ) q k o ( ö ) q	ɛ k o ( ʔ o ) ʔ k o ( ʔ o ) ʔ
oeietjo	oe ie tj o	u i t͡ʃ o
èpo(ah)ha	è p o ( a h ) h a	ɛ p o ( a h ) h a
èpoh	è p o h	ɛ p o h
èpohkèaq	è p o h k è a q	ɛ p o h k ɛ a ʔ
èpoko	è p o k o	ɛ p o k o
èponanamè	è p o n a n a m è	ɛ p o n a n a m ɛ
èpo(ö)kaha	è p o ( ö ) k a h a	ɛ p o ( ʔ o ) k a h a
èpoökie	è p o ö k ie	ɛ p o ʔ o k i
èpoqa	è p o q a	ɛ p o ʔ a
èpo(q)ienamo	è p o ( q ) ie n a m o	ɛ p o ( ʔ ) i n a m o
èporo	è p o r o	ɛ p o r o
(èq)èhoenè	( è q ) è h oe n è	( ɛ ʔ ) ɛ h u n ɛ
ètèbè	è t è b è	ɛ t ɛ b ɛ
èwakiepöro	è w a k ie p ö r o	ɛ w a k i p ɨ r o
garam	g a r a m	g a r a m
goeroe	g oe r oe	g u r u
ha	h a	h a
habakao	h a b a k a o	h a b a k a o
haboejaq	h a b oe j a q	h a b u j a ʔ
haie	h a ie	h a i
haiejaha	h a ie j a h a	h a i j a h a
abahaiejaha	a b a h a ie j a h a	a b a h a i j a h a
kahaiejaha	k a h a ie j a h a	k a h a i j a h a
halè	h a l è	h a l ɛ
hamèhènie	h a m è h è n ie	h a m ɛ h ɛ n i
haoe	h a oe	h a u
hèdapiehie	h è d a p ie h ie	h ɛ d a p i ç i
hèie(j)o	h è ie ( j ) o	h ɛ i ( j ) o
hie	h ie	h i
hiebaie	h ie b a ie	h i b a i
hieie(j)oie(j)o	h ie ie ( j ) o ie ( j ) o	h i i ( j ) o i ( j ) o
hie(j)onie	h ie ( j ) o n ie	h i ( j ) o n i
hienoea	h ie n oe a	h i n u a
ho	h o	h o
hoäkoqaq	h o ä k o q a q	h o ʔ a k o ʔ a ʔ
hobaäoeie(j)aka	h o b a ä oe ie ( j ) a k a	h o b a ʔ a u i ( j ) a k a
hobaäoe(w)a	h o b a ä oe ( w ) a	h o b a ʔ a u ( w ) a
hobahaba	h o b a h a b a	h o b a h a b a
hobèèaö	h o b è è a ö	h o b ɛ ɛ a ʔ o
hoboek	h o b oe k	h o b u k
hödahöda	h ö d a h ö d a	h ɨ d a h ɨ d a
hodiedieka	h o d ie d ie k a	h o d i d i k a
hodiekie	h o d ie k ie	h o d i k i
hoèana	h oè a n a	h u a n a
hoeka	h oe k a	h u k a
hoeko(q)ä	h oe k o (q)ä	h u k o ( ʔ ) a
hoeoenoeka	h oeoe n oe k a	h u ʔ u n u k a
hoie	h o ie	h o i
höka	h ö k a	h ɨ k a
homaie	h o m a ie	h o m a i
homanieka	h o m a n ie k a	h o m a n i k a
hona(o)	h o n a ( o )	h o n a ( o )
honoaha	h o n o a h a	h o n o a h a
hopaie	h o p a ie	h o p a i
hopanao	h o p a n a o	h o p a n a o
ie	ie	i
iedjie	ie dj ie	i d͡ʒ i
ieho	ie h o	i ç o
ieho akoloe poq	ie h o # a k o l oe # p o q	i ç o # a k o l u # p o ʔ
iehoie(j)ana	ie h o ie ( j ) a n a	i ç o i ( j ) a n a
ie(j)aäo	ie ( j ) a ä o	i ( j ) a ʔ a o
ie(j)abie	ie ( j ) a b ie	i ( j ) a b i
ie(j)aha(ie)	ie ( j ) a h a ( ie )	i ( j ) a h a ( i )
ie(j)ahaoeoeaq	ie ( j ) a h a oeoe a q	i ( j ) a h a u ʔ u a ʔ
ie(j)o	ie ( j ) o	i ( j ) o
ie(j)oho	ie ( j ) o h o	i ( j ) o h o
ie(j)okie	ie ( j ) o k ie	i ( j ) o k i
ie(j)omoö	ie ( j ) o m o ö	i ( j ) o m o ʔ o
ie(j)onie	ie ( j ) o n ie	i ( j ) o n i
ie(j)onie(j)a	ie ( j ) o n ie ( j ) a	i ( j ) o n i ( j ) a
ieka	ie k a	i k a
iekahaö	ie k a h a ö	i k a h a ʔ o
iekahoboe(w)ara	ie k a h o b oe ( w ) a r a	i k a h o b u ( w ) a r a
iekara	ie k a r a	i k a r a
iekoedoha	ie k oe d o h a	i k u d o h a
iekoeko	ie k oe k o	i k u k o
ienaou(w)a	ie n a o u ( w ) a	i n a o u ( w ) a
ienoenoeq	ie n oe n oe q	i n u n u ʔ
ienoqie	ie n o q ie	i n o ʔ i
ietaqoe(w)a	ie t a q oe ( w ) a	i t a ʔ u ( w ) a
ietèq	ie t è q	i t ɛ ʔ
ietjo	ie tj o	i t͡ʃ o
ietjoehaq	ie tj oe h a q	i t͡ʃ u h a ʔ
ka	k a	k a
kaä	k a ä	k a ʔ a
kaäämie	k a ä ä m ie	k a ʔ a ʔ a m i
kaä(ä)oe(w)a	k a ä ( ä ) oe ( w ) a	k a ʔ a ( ʔ a ) u ( w ) a
kaädahoaie	k a ä d a h o a ie	k a ʔ a d a h o a i
kaädodie	k a ä d o d ie	k a ʔ a d o d i
kaädo(j)a	k a ä d o ( j ) a	k a ʔ a d o ( j ) a
kaähoeöie	k a ä h oe ö ie	k a ʔ a h u ʔ o i
kaäjoq	k a ä j o q	k a ʔ a j o ʔ
ka(ä)kèo	k a ( ä ) k è o	k a ( ʔ a ) k ɛ o
kaäkèho	k a ä k è h o	k a ʔ a k ɛ h o
kaäkie	k a ä k ie	k a ʔ a k i
kaäkieè	k a ä k ie è	k a ʔ a k i ɛ
kaäkiekie(j)ĕ	k a ä k ie k ie ( j ) ĕ	k a ʔ a k i k i ( j ) ə
kaäkienafah	k a ä k ie n a f a h	k a ʔ a k i n a f a h
kaäkienè	k a ä k ie n è	k a ʔ a k i n ɛ
kaäkieniepa	k a ä k ie n ie p a	k a ʔ a k i n i p a
kaäkoeka(h)	k a ä k oe k a ( h )	k a ʔ a k u k a ( h )
kaäkoho	k a ä k o h o	k a ʔ a k o h o
kaämie	k a ä m ie	k a ʔ a m i
kaäoe	k a ä oe	k a ʔ a u
kaäpaoe	k a ä p a oe	k a ʔ a p a u
kaäpèaäaq	k a ä p è a ä a q	k a ʔ a p ɛ a ʔ a a ʔ
kaäpoho	k a ä p o h o	k a ʔ a p o h o
kababahaq	k a b a b a h a q	k a b a b a h a ʔ
kabáèlo	k a b á è l o	k a b a ɛ l o
kabahoa	k a b a h o a	k a b a h o a
kabahöjaäq	k a b a h ö j a ä q	k a b a h ɨ j a ʔ a ʔ
kabakoä	k a b a k o ä	k a b a k o ʔ a
kabatjoä	k a b a tj o ä	k a b a t͡ʃ o ʔ a
kabĕa	k a b ĕ a	k a b ə a
kabèhoq	k a b è h o q	k a b ɛ h o ʔ
kabiekaka	k a b ie k a k a	k a b i k a k a
kabiekèbie	k a b ie k è b ie	k a b i k ɛ b i
kaboe(w)aboe(w)a	k a b oe ( w ) a b oe ( w ) a	k a b u ( w ) a b u ( w ) a
kaboekoe	k a b oe k oe	k a b u k u
kadèadèa	k a d è a d è a	k a d ɛ a d ɛ a
kadèda	k a d è d a	k a d ɛ d a
kadèdè	k a d è d è	k a d ɛ d ɛ
kadiehie	k a d ie h ie	k a d i ç i
kadiekopo	k a d ie k o p o	k a d i k o p o
kadoboedoboe	k a d o b oe d o b oe	k a d o b u d o b u
kadodohodie	k a d o d o h o d ie	k a d o d o h o d i
kadoèhoeda	k a d oè h oe d a	k a d u h u d a
kadoqö	k a d o q ö	k a d o ʔ ɨ
kaènaha	k a è n a h a	k a ɛ n a h a
kaènoe	k a è n oe	k a ɛ n u
kaèöèo	k a è ö è o	k a ɛ ɨ ɛ o
kah	k a h	k a h
kaha	k a h a	k a h a
kahabaja	k a h a b a j a	k a h a b a j a
kahabaoeba	k a h a b a oe b a	k a h a b a u b a
kahabarieq	k a h a b a r ie q	k a h a b a r i ʔ
kahabieta	k a h a b ie t a	k a h a b i t a
kahaè	k a h a è	k a h a ɛ
kahapa	k a h a p a	k a h a p a
kahaho	k a h a h o	k a h a h o
kahaie	k a h a ie	k a h a i
kahaiekoenaq	k a h a ie k oe n a q	k a h a i k u n a ʔ
kahaienoeapè	k a h a ie n oe a p è	k a h a i n u a p ɛ
kahaja	k a h a j a	k a h a j a
kahakakie	k a h a k a k ie	k a h a k a k i
kahakouda	k a h a k o u d a	k a h a k o u d a
kahao	k a h a o	k a h a o
kahao: èmanie	k a h a o : # è m a n ie	k a h a o : # ɛ m a n i
èhöda	è h ö d a	ɛ h ɨ d a
kahaoeq	k a h a oe q	k a h a u ʔ
kahaoka	k a h a o k a	k a h a o k a
kahapaq	k a h a p a q	k a h a p a ʔ
kahapie	k a h a p ie	k a h a p i
kahapoeoeie(j)a	k a h a p oeoe ie ( j ) a	k a h a p u ʔ u i ( j ) a
kahapoeqoeie	k a h a p oe q oe ie	k a h a p u ʔ u i
kaharao	k a h a r a o	k a h a r a o
kahèdohèdo	k a h è d o h è d o	k a h ɛ d o h ɛ d o
kahèè	k a h è è	k a h ɛ ɛ
kahè(j)oq	k a h è ( j ) o q	k a h ɛ ( j ) o ʔ
kahiekanie	k a h ie k a n ie	k a h i k a n i
kahienoaq	k a h ie n o a q	k a h i n o a ʔ
kahiepa	k a h ie p a	k a h i p a
kahoeie(j)oeroe(w)a	k a h oe ie ( j ) oe r oe ( w ) a	k a h u i ( j ) u r u ( w ) a
kahoepohoepoö	k a h oe p o h oe p o ö	k a h u p o h u p o ʔ o
kahopo	k a h o p o	k a h o p o
kahö(w)a	k a h ö ( w ) a	k a h ɨ ( w ) a
kaie	k a ie	k a i
kaie(j)aè	k a ie ( j ) a è	k a i ( j ) a ɛ
kaie(j)anono	k a ie ( j ) a n o n o	k a i ( j ) a n o n o
kaie(j)ojo(q)	k a ie ( j ) o j o ( q )	k a i ( j ) o j o ( ʔ )
kaiekoko	k a ie k o k o	k a i k o k o
kaienono(q)	k a ie n o n o ( q )	k a i n o n o ( ʔ )
kajajaä	k a j a j a ä	k a j a j a ʔ a
kajo	k a j o	k a j o
kajoöie	k a j o ö ie	k a j o ʔ o i
kakanaka	k a k a n a k a	k a k a n a k a
kakanakoe(w)a	k a k a n a k oe ( w ) a	k a k a n a k u ( w ) a
kakanèha	k a k a n è h a	k a k a n ɛ h a
kakaraie	k a k a r a ie	k a k a r a i
kakarie(j)o	k a k a r ie ( j ) o	k a k a r i ( j ) o
kakèkaka	k a k è k a k a	k a k ɛ k a k a
kakèlèha	k a k è l è h a	k a k ɛ l ɛ h a
kakiedahaie(j)o	k a k ie d a h a ie ( j ) o	k a k i d a h a i ( j ) o
kakiedjoa	k a k ie dj o a	k a k i d͡ʒ o a
kakiedohè	k a k ie d o h è	k a k i d o h ɛ
kakiekiedohè	k a k ie k ie d o h è	k a k i k i d o h ɛ
kakiekie(j)oe	k a k ie k ie ( j ) oe	k a k i k i ( j ) u
kakiepakiepa	k a k ie p a k ie p a	k a k i p a k i p a
kakoehè	k a k oe h è	k a k u h ɛ
kakoenjè	k a k oe nj è	k a k u ɲ ɛ
kakoeöqö	k a k oe ö q ö	k a k u ʔ o ʔ ɨ
kaköoe	k a k ö oe	k a k ɨ u
kakoro(w)a	k a k o r o ( w ) a	k a k o r o ( w ) a
kalèaq	k a l è a q	k a l ɛ a ʔ
kalèaq(oe)baba	k a l è a q ( oe ) b a b a	k a l ɛ a ʔ ( u ) b a b a
kamanaä	k a m a n a ä	k a m a n a ʔ a
kamoepie	k a m oe p ie	k a m u p i
kamoenieno	k a m oe n ie n o	k a m u n i n o
kamoho	k a m o h o	k a m o h o
kamonie	k a m o n ie	k a m o n i
kanakienie	k a n a k ie n ie	k a n a k i n i
kanapoe	k a n a p oe	k a n a p u
kanapoeäq	k a n a p oe ä q	k a n a p u ʔ a ʔ
kanapoenoe	k a n a p oe n oe	k a n a p u n u
kanèko	k a n è k o	k a n ɛ k o
kanènè	k a n è n è	k a n ɛ n ɛ
kanènonèno	k a n è n o n è n o	k a n ɛ n o n ɛ n o
kanèonèo	k a n è o n è o	k a n ɛ o n ɛ o
kanèpoe	k a n è p oe	k a n ɛ p u
kanè(q)a	k a n è ( q ) a	k a n ɛ ( ʔ ) a
kaniehie	k a n ie h ie	k a n i ç i
kaniekie	k a n ie k ie	k a n i k i
kaniekoä(a)q	k a n ie k o ä ( a ) q	k a n i k o ʔ a ( a ) ʔ
kanie(nie)kie	k a n ie ( n ie ) k ie	k a n i ( n i ) k i
kanieniepo(w)a	k a n ie n ie p o ( w ) a	k a n i n i p o ( w ) a
kanoeaie	k a n oe a ie	k a n u a i
kanoeanoea	k a n oe a n oe a	k a n u a n u a
kanoeqkoe(w)aie	k a n oe q k oe ( w ) a ie	k a n u ʔ k u ( w ) a i
kanoöho(w)aq	k a n o ö h o ( w ) a q	k a n o ʔ o h o ( w ) a ʔ
kao(e)	k a o ( e )	k a o ( e )
kaoeäq	k a oe ä q	k a u ʔ a ʔ
kaoedada	k a oe d a d a	k a u d a d a
kaoedahjo	k a oe d a h j o	k a u d a h j o
kaoedaoe(w)arah	k a oe d a oe ( w ) a r a h	k a u d a u ( w ) a r a h
kaoedèqää	k a oe d è q ää	k a u d ɛ ʔ a ʔ a
kaoenie(j)a	k a oe n ie ( j ) a	k a u n i ( j ) a
kaoepè(q)	k a oe p è ( q )	k a u p ɛ ( ʔ )
kaoe(w)a	k a oe ( w ) a	k a u ( w ) a
kaoe(w)èoe(w)è	k a oe ( w ) è oe ( w ) è	k a u ( w ) ɛ u ( w ) ɛ
kaoe(w)ie	k a oe ( w ) ie	k a u ( w ) i
kaokie	k a o k ie	k a o k i
kaoöbo	k a o ö b o	k a o ʔ o b o
kaoöèiedjie	k a o ö è ie dj ie	k a o ʔ o ɛ i d͡ʒ i
kaoöo	k a o ö o	k a o ʔ o o
kapaie	k a p a ie	k a p a i
kapal	k a p a l	k a p a l
kapal api	k a p a l # a p i	k a p a l # a p i
kapaoe	k a p a oe	k a p a u
kapĕrapĕraba	k a p ĕ r a p ĕ r a b a	k a p ə r a p ə r a b a
kapieho	k a p ie h o	k a p i ç o
kapoe	k a p oe	k a p u
kapoeho	k a p oe h o	k a p u h o
kapoeka	k a p oe k a	k a p u k a
kapoeq(oe)a	k a p oe q ( oe ) a	k a p u ʔ ( u ) a
kapoko	k a p o k o	k a p o k o
kapopo	k a p o p o	k a p o p o
kĕpopo	k ĕ p o p o	k ə p o p o
kaqakaie	k a q a k a ie	k a ʔ a k a i
kaqamano	k a q a m a n o	k a ʔ a m a n o
kaqapopoero	k a q a p o p oe r o	k a ʔ a p o p u r o
kaqienèaoe	k a q ie n è a oe	k a ʔ i n ɛ a u
karaoe	k a r a oe	k a r a u
karieporiepo	k a r ie p o r ie p o	k a r i p o r i p o
karoe(oe)(w)a	k a r oe ( oe ) ( w ) a	k a r u ( u ) ( w ) a
karohaja	k a r o h a j a	k a r o h a j a
karorie(j)ĕ	k a r o r ie ( j ) ĕ	k a r o r i ( j ) ə
kĕbahè	k ĕ b a h è	k ə b a h ɛ
kĕlamboe	k ĕ l a m b oe	k ə l a m b u
kĕmie(j)oe	k ĕ m ie ( j ) oe	k ə m i ( j ) u
kĕnaja	k ĕ n a j a	k ə n a j a
kĕwalie	k ĕ w a l ie	k ə w a l i
kè	k è	k ɛ
kèè	k è è	k ɛ ɛ
kèhèkoq	k è h è k o q	k ɛ h ɛ k o ʔ
kèhèla	k è h è l a	k ɛ h ɛ l a
kèho	k è h o	k ɛ h o
kèhodojo	k è h o d o j o	k ɛ h o d o j o
kèhowa	k è h o w a	k ɛ h o w a
kèkèqie	k è k è q ie	k ɛ k ɛ ʔ i
kèkoe(w)èq	k è k oe ( w ) è q	k ɛ k u ( w ) ɛ ʔ
kèlokèlo	k è l o k è l o	k ɛ l o k ɛ l o
kèma	k è m a	k ɛ m a
kèmonaq	k è m o n a q	k ɛ m o n a ʔ
kèo	k è o	k ɛ o
kie	k ie	k i
kiea	k ie a	k i a
kieadoboe	k ie a d o b oe	k i a d o b u
kieakie	k ie a k ie	k i a k i
kieakoena	k ie a k oe n a	k i a k u n a
kieakoeq	k ie a k oe q	k i a k u ʔ
kieapaä	k ie a p a ä	k i a p a ʔ a
kiebaka	k ie b a k a	k i b a k a
kiebèdieka	k ie b è d ie k a	k i b ɛ d i k a
kieboeho	k ie b oe h o	k i b u h o
kiebohèie	k ie b o h è ie	k i b o h ɛ i
kiedahoho	k ie d a h o h o	k i d a h o h o
kiedahaq	k ie d a h a q	k i d a h a ʔ
kiedahoaq	k ie d a h o a q	k i d a h o a ʔ
kiedajaq	k ie d a j a q	k i d a j a ʔ
kiedaoedaoe	k ie d a oe d a oe	k i d a u d a u
kiedara	k ie d a r a	k i d a r a
kiedèdè(j)aq	k ie d è d è ( j ) a q	k i d ɛ d ɛ ( j ) a ʔ
kiedie	k ie d ie	k i d i
kiedie (è)kèho	k ie d ie # ( è ) k è h o	k i d i # ( ɛ ) k ɛ h o
kiediediehoq	k ie d ie d ie h o q	k i d i d i ç o ʔ
kiediedieka	k ie d ie d ie k a	k i d i d i k a
kiedieopè	k ie d ie o p è	k i d i o p ɛ
kiediepoe	k ie d ie p oe	k i d i p u
kiediepoe (èq)èhoenè	k ie d ie p oe # ( è q ) è h oe n è	k i d i p u # ( ɛ ʔ ) ɛ h u n ɛ
kiedjaieie(j)aq	k ie dj a ie ie ( j ) a q	k i d͡ʒ a i i ( j ) a ʔ
kiedjie	k ie dj ie	k i d͡ʒ i
kiedjiedjieö	k ie dj ie dj ie ö	k i d͡ʒ i d͡ʒ i ʔ o
kiedjiekiedjie	k ie dj ie k ie dj ie	k i d͡ʒ i k i d͡ʒ i
kiedjoro	k ie dj o r o	k i d͡ʒ o r o
kiedo	k ie d o	k i d o
kiedobieka	k ie d o b ie k a	k i d o b i k a
kiedodo	k ie d o d o	k i d o d o
kiedodo iedjie	k ie d o d o # ie dj ie	k i d o d o # i d͡ʒ i
kiedoropoq	k ie d o r o p o q	k i d o r o p o ʔ
kieè(ja)	k ie è ( j a )	k i ɛ ( j a )
kièèlo	k iè è l o	k i ɛ l o
kieènoe	k ie è n oe	k i ɛ n u
kiehiebie(j)a	k ie h ie b ie ( j ) a	k i ç i b i ( j ) a
kiehiema(na)	k ie h ie m a ( n a )	k i ç i m a ( n a )
kiehiema(na)èodie	k ie h ie m a ( n a ) è o d ie	k i ç i m a ( n a ) ɛ o d i
kiehieoba	k ie h ie o b a	k i ç i o b a
kiehoè(j)a	k ie h oè ( j ) a	k i ç u ( j ) a
kiehohoda(q)	k ie h o h o d a ( q )	k i ç o h o d a ( ʔ )
kieiedoka	k ie ie d o k a	k i i d o k a
kieie(j)oèdaha	k ie ie ( j ) oè d a h a	k i i ( j ) u d a h a
kieiepo	k ie ie p o	k i i p o
kieietjo	k ie ie tj o	k i i t͡ʃ o
kie(j)a	k ie ( j ) a	k i ( j ) a
kie(j)abaq	k ie ( j ) a b a q	k i ( j ) a b a ʔ
kie(j)abaq iekèo	k ie ( j ) a b a q # ie k è o	k i ( j ) a b a ʔ # i k ɛ o
kie(j)ahariedjoe	k ie ( j ) a h a r ie dj oe	k i ( j ) a h a r i d͡ʒ u
kie(j)aie	k ie ( j ) a ie	k i ( j ) a i
kie(j)oenano	k ie ( j ) oe n a n o	k i ( j ) u n a n o
kie(j)oèdoha	k ie ( j ) oè d o h a	k i ( j ) u d o h a
kie(j)oha	k ie ( j ) o h a	k i ( j ) o h a
kie(j)oho	k ie ( j ) o h o	k i ( j ) o h o
kie(j)okko	k ie ( j ) o k k o	k i ( j ) o k k o
kie(j)opèka	k ie ( j ) o p è k a	k i ( j ) o p ɛ k a
kie(j)oqoqaq	k ie ( j ) o q o q a q	k i ( j ) o ʔ o ʔ a ʔ
kiekaäboe	k ie k a ä b oe	k i k a ʔ a b u
kiekaäna	k ie k a ä n a	k i k a ʔ a n a
kiekabiedja	k ie k a b ie dj a	k i k a b i d͡ʒ a
kiekahaoeba	k ie k a h a oe b a	k i k a h a u b a
kiekaoba	k ie k a o b a	k i k a o b a
kiekaraq(a)	k ie k a r a q ( a )	k i k a r a ʔ ( a )
kiekĕnènaq	k ie k ĕ n è n a q	k i k ə n ɛ n a ʔ
kiekĕroa	k ie k ĕ r o a	k i k ə r o a
kiekèèla	k ie k è è l a	k i k ɛ ɛ l a
kiekè(è)oe(w)a	k ie k è ( è ) oe ( w ) a	k i k ɛ ( ɛ ) u ( w ) a
kiekèora(q)	k ie k è o r a ( q )	k i k ɛ o r a ( ʔ )
kiekèpoqä	k ie k è p o qä	k i k ɛ p o ʔ a
kiekèpoqoe(w)a	k ie k è p o q oe ( w ) a	k i k ɛ p o ʔ u ( w ) a
kiekèqie	k ie k è q ie	k i k ɛ ʔ i
kiekie(j)a	k ie k ie ( j ) a	k i k i ( j ) a
kiekie(j)aqkie(j)aq	k ie k ie ( j ) a q k ie ( j ) a q	k i k i ( j ) a ʔ k i ( j ) a ʔ
kiekie(j)ara	k ie k ie ( j ) a r a	k i k i ( j ) a r a
kiekie(j)o	k ie k ie ( j ) o	k i k i ( j ) o
kiekienie	k ie k ie n ie	k i k i n i
kiekoekoe(q)ö	k ie k oe k oe ( q ) ö	k i k u k u ( ʔ ) ɨ
kiekoho	k ie k o h o	k i k o h o
kiekohodaq	k ie k o h o d a q	k i k o h o d a ʔ
kiekoko	k ie k o k o	k i k o k o
kiekokonie(j)a	k ie k o k o n ie ( j ) a	k i k o k o n i ( j ) a
kiekononaq	k ie k o n o n a q	k i k o n o n a ʔ
kiekooe(w)a	k ie k o oe ( w ) a	k i k o u ( w ) a
kiekoöka	k ie k o ö k a	k i k o ʔ o k a
kiekoro(w)a	k ie k o r o ( w ) a	k i k o r o ( w ) a
kielaoeloe	k ie l a oe l oe	k i l a u l u
kiemèmè èbahaoeq	k ie m è m è # è b a h a oe q	k i m ɛ m ɛ # ɛ b a h a u ʔ
kiemoenie	k ie m oe n ie	k i m u n i
kiemoenie(j)o	k ie m oe n ie ( j ) o	k i m u n i ( j ) o
kiemomojo	k ie m o m o j o	k i m o m o j o
kienanaja	k ie n a n a j a	k i n a n a j a
kienanapa	k ie n a n a p a	k i n a n a p a
kienienaqèkaq	k ie n ie n a q è k a q	k i n i n a ʔ ɛ k a ʔ
kienienèqa	k ie n ie n è q a	k i n i n ɛ ʔ a
kienjono	k ie nj o n o	k i ɲ o n o
kieno	k ie n o	k i n o
kienoäo	k ie n o ä o	k i n o ʔ a o
kienoeoeka	k ie n oeoe k a	k i n u ʔ u k a
kienono	k ie n o n o	k i n o n o
kienono: è(j)a	k ie n o n o : # è ( j ) a	k i n o n o : # ɛ ( j ) a
è(j)adie(j)a	è ( j ) a d ie ( j ) a	ɛ ( j ) a d i ( j ) a
è(j)aè	è ( j ) a è	ɛ ( j ) a ɛ
kienoöna(w)aie	k ie n o ö n a ( w ) a ie	k i n o ʔ o n a ( w ) a i
kienoqè(j)a	k ie n o q è ( j ) a	k i n o ʔ ɛ ( j ) a
kiodèa	k i o d è a	k i o d ɛ a
kieoenèkaq	k ie oe n è k a q	k i u n ɛ k a ʔ
kieojo	k ie o j o	k i o j o
kieokahaie	k ie o k a h a ie	k i o k a h a i
kieonieka	k ie o n ie k a	k i o n i k a
kieoö	k ie o ö	k i o ʔ o
kieoöäaq	k ie o ö ä a q	k i o ʔ o ʔ a a ʔ
kieoöie	k ie o ö ie	k i o ʔ o i
kieoöno	k ie o ö n o	k i o ʔ o n o
kieoönopa	k ie o ö n o p a	k i o ʔ o n o p a
kiepa(a)oeq	k ie p a ( a ) oe q	k i p a ( a ) u ʔ
kiepadie; kiepadieoeiedjie	k ie p a d ie ; # k ie p a d ie oe ie dj ie	k i p a d i ; # k i p a d i u i d͡ʒ i
kiepahoe(w)a	k ie p a h oe ( w ) a	k i p a h u ( w ) a
kiepaka	k ie p a k a	k i p a k a
kiepakaowaq	k ie p a k a o w a q	k i p a k a o w a ʔ
kiepakiedja	k ie p a k ie dj a	k i p a k i d͡ʒ a
kiepa; kiepakiepa pahoeoenaq	k ie p a ; # k ie p a k ie p a # p a h oeoe n a q	k i p a ; # k i p a k i p a # p a h u ʔ u n a ʔ
kiepakobaq	k ie p a k o b a q	k i p a k o b a ʔ
kiepakoeka	k ie p a k oe k a	k i p a k u k a
kiepakoekoeoedie	k ie p a k oe k oeoe d ie	k i p a k u k u ʔ u d i
kiepakoko	k ie p a k o k o	k i p a k o k o
kiepakokokie	k ie p a k o k o k ie	k i p a k o k o k i
kiepamiemiehieka	k ie p a m ie m ie h ie k a	k i p a m i m i ç i k a
kiepamo	k ie p a m o	k i p a m o
kiepamoemoeoeie	k ie p a m oe m oeoe ie	k i p a m u m u ʔ u i
kiepapakoe	k ie p a p a k oe	k i p a p a k u
kiepaqaq	k ie p a q a q	k i p a ʔ a ʔ
kieparaèbahao(q)	k ie p a r a è b a h a o ( q )	k i p a r a ɛ b a h a o ( ʔ )
kieparahpie	k ie p a r a h p ie	k i p a r a h p i
kieparahopie	k ie p a r a h o p ie	k i p a r a h o p i
kieparoa	k ie p a r o a	k i p a r o a
kiepĕraiedie(j)og	k ie p ĕ r a ie d ie ( j ) o g	k i p ə r a i d i ( j ) o g
kiepĕhaie	k ie p ĕ h a ie	k i p ə h a i
kiepèhèboeöbo	k ie p è h è b oe ö b o	k i p ɛ h ɛ b u ʔ o b o
kiepèhodo	k ie p è h o d o	k i p ɛ h o d o
kiepèoraq	k ie p è o r a q	k i p ɛ o r a ʔ
kiepiepie	k ie p ie p ie	k i p i p i
kiepoäka	k ie p o ä k a	k i p o ʔ a k a
kiepoäraq	k ie p o ä r a q	k i p o ʔ a r a ʔ
kiepoedieka	k ie p oe d ie k a	k i p u d i k a
kiepoefoe	k ie p oe f oe	k i p u f u
kiepoeoeda	k ie p oeoe d a	k i p u ʔ u d a
kiepoe(w)a	k ie p oe ( w ) a	k i p u ( w ) a
kiepohajĕ	k ie p o h a j ĕ	k i p o h a j ə
kiepokana	k ie p o k a n a	k i p o k a n a
kiepokiepo	k ie p o k ie p o	k i p o k i p o
kiepoö	k ie p o ö	k i p o ʔ o
kiepopoä	k ie p o p o ä	k i p o p o ʔ a
kiepoqöaq	k ie p o q ö a q	k i p o ʔ ɨ a ʔ
kieqja	k ie q j a	k i ʔ j a
koahajo	k o a h a j o	k o a h a j o
koahie(j)a	k o a h ie ( j ) a	k o a h i ( j ) a
koahie(j)a kapoe	k o a h ie ( j ) a # k a p oe	k o a h i ( j ) a # k a p u
köda	k ö d a	k ɨ d a
kodo	k o d o	k o d o
koe	k oe	k u
koeano	k oe a n o	k u a n o
koedaqä	k oe d a qä	k u d a ʔ a
koedè	k oe d è	k u d ɛ
koedè: iejaha	k oe d è : # ie j a h a	k u d ɛ : # i j a h a
iepoko	ie p o k o	i p o k o
ietopo	ie t o p o	i t o p o
koedèja	k oe d è j a	k u d ɛ j a
koedodoka	k oe d o d o k a	k u d o d o k a
koedoe	k oe d oe	k u d u
koehaie	k oe h a ie	k u h a i
koehèdie	k oe h è d ie	k u h ɛ d i
koehèdie(j)aq	k oe h è d ie ( j ) a q	k u h ɛ d i ( j ) a ʔ
koehiemaq	k oe h ie m a q	k u h i m a ʔ
koeie; koeie karieha	k oe ie ; # k oe ie # k a r ie h a	k u i ; # k u i # k a r i ç a
koeiehie	k oe ie h ie	k u i ç i
koeienaq	k oe ie n a q	k u i n a ʔ
koejaq	k oe j a q	k u j a ʔ
koekaq	k oe k a q	k u k a ʔ
koekoebaka	k oe k oe b a k a	k u k u b a k a
koemènoeè	k oe m è n oe è	k u m ɛ n u ɛ
koemoe	k oe m oe	k u m u
koenajo	k oe n a j o	k u n a j o
koepèie	k oe p è ie	k u p ɛ i
koeripo	k oe r i p o	k u r i p o
koe(w)a	k oe ( w ) a	k u ( w ) a
koe(w)adie	k oe ( w ) a d ie	k u ( w ) a d i
kohèaq	k o h è a q	k o h ɛ a ʔ
kohopaie	k o h o p a ie	k o h o p a i
kohopie(j)oe	k o h o p ie ( j ) oe	k o h o p i ( j ) u
kokieha	k o k ie h a	k o k i ç a
kokoäaq	k o k o ä a q	k o k o ʔ a a ʔ
kokoĕ	k o k o ĕ	k o k o ə
kokoie(j)aèa	k o k o ie ( j ) a è a	k o k o i ( j ) a ɛ a
kokona	k o k o n a	k o k o n a
(ko)koro(w)a	( k o ) k o r o ( w ) a	( k o ) k o r o ( w ) a
kolè	k o l è	k o l ɛ
komojaqä	k o m o j a qä	k o m o j a ʔ a
komokomo	k o m o k o m o	k o m o k o m o
konèka	k o n è k a	k o n ɛ k a
konohaq(?)	k o n o h a q ( ? )	k o n o h a ʔ ( ? )
kononaq	k o n o n a q	k o n o n a ʔ
koöma	k o ö m a	k o ʔ o m a
kopènè	k o p è n è	k o p ɛ n ɛ
kopèq	k o p è q	k o p ɛ ʔ
kopo	k o p o	k o p o
kopodieqie	k o p o d ie q ie	k o p o d i ʔ i
koqoq	k o q o q	k o ʔ o ʔ
koqoqma	k o q o q m a	k o ʔ o ʔ m a
koqowie	k o q o w ie	k o ʔ o w i
koraq	k o r a q	k o r a ʔ
ma(ä)hona	m a ( ä ) h o n a	m a ( ʔ a ) h o n a
mahamè	m a h a m è	m a h a m ɛ
mahona(q)	m a h o n a ( q )	m a h o n a ( ʔ )
maonè	m a o n è	m a o n ɛ
mĕnokie	m ĕ n o k ie	m ə n o k i
miemie	m ie m ie	m i m i
miemiena	m ie m ie n a	m i m i n a
miena; mienaoe(w)apo	m ie n a ; # m ie n a oe ( w ) a p o	m i n a ; # m i n a u ( w ) a p o
mienaoe(w)aie	m ie n a oe ( w ) a ie	m i n a u ( w ) a i
mienjaq	m ie nj a q	m i ɲ a ʔ
moe	m oe	m u
mohoie	m o h o ie	m o h o i
mohomohoiena	m o h o m o h o ie n a	m o h o m o h o i n a
mokie	m o k ie	m o k i
moko	m o k o	m o k o
moko èodie die(j)a	m o k o # è o d ie # d ie ( j ) a	m o k o # ɛ o d i # d i ( j ) a
moö	m o ö	m o ʔ o
naäie(j)aha	n a ä ie ( j ) a h a	n a ʔ a i ( j ) a h a
naäpoe(w)aka(q)	n a ä p oe ( w ) a k a ( q )	n a ʔ a p u ( w ) a k a ( ʔ )
naèhapè	n a è h a p è	n a ɛ h a p ɛ
nahaja	n a h a j a	n a h a j a
naienaie	n a ie n a ie	n a i n a i
naoemana	n a oe m a n a	n a u m a n a
naponaq	n a p o n a q	n a p o n a ʔ
naqä	n a qä	n a ʔ a
naqie(j)aie	n a q ie ( j ) a ie	n a ʔ i ( j ) a i
nèènie	n è è n ie	n ɛ ɛ n i
nènèka	n è n è k a	n ɛ n ɛ k a
nie(j)a	n ie ( j ) a	n i ( j ) a
nie(j)oöhieniea	n ie ( j ) o ö h ie n ie a	n i ( j ) o ʔ o h i n i a
noaha; kienoaha	n o a h a ; # k ie n o a h a	n o a h a ; # k i n o a h a
noahaq	n o a h a q	n o a h a ʔ
noèaäq	n oè a ä q	n u a ʔ a ʔ
noenohoie	n oe n o h o ie	n u n o h o i
noha	n o h a	n o h a
nokie	n o k ie	n o k i
noöienĕ	n o ö ie n ĕ	n o ʔ o i n ə
noönie	n o ö n ie	n o ʔ o n i
no(q)o(q)ie	n o ( q ) o ( q ) ie	n o ( ʔ ) o ( ʔ ) i
oanoaha	o a n o a h a	o a n o a h a
obieoe(w)oeha	o b ie oe ( w ) oe h a	o b i u ( w ) u h a
ödaq	ö d a q	ɨ d a ʔ
odokie	o d o k ie	o d o k i
oe	oe	u
oedaq	oe d a q	u d a ʔ
oekèèpa	oe k è è p a	u k ɛ ɛ p a
oekiedopè	oe k ie d o p è	u k i d o p ɛ
oemahaie	oe m a h a ie	u m a h a i
oemahaoe	oe m a h a oe	u m a h a u
oenèqie	oe n è q ie	u n ɛ ʔ i
oeniekaq	oe n ie k a q	u n i k a ʔ
oeöbie	oe ö b ie	u ʔ o b i
oeoe	oeoe	u ʔ u
oepanie	oe p a n ie	u p a n i
oepè	oe p è	u p ɛ
oepĕhöjaäq	oe p ĕ h ö j a ä q	u p ə h ɨ j a ʔ a ʔ
oepoena(ie)	oe p oe n a ( ie )	u p u n a ( i )
oe(w)a	oe ( w ) a	u ( w ) a
oe(w)aha	oe ( w ) a h a	u ( w ) a h a
oewĕoewĕ	oe w ĕ oe w ĕ	u w ə u w ə
okaie	o k a ie	o k a i
okie	o k ie	o k i
omiekoaqaha	o m ie k o a q a h a	o m i k o a ʔ a h a
omö	o m ö	o m ɨ
öö	ö ö	ɨ ɨ
oödokie	o ö d o k ie	o ʔ o d o k i
oökie(?)	o ö k ie ( ? )	o ʔ o k i ( ? )
opahie(j)aka	o p a h ie ( j ) a k a	o p a h i ( j ) a k a
opèkaäq	o p è k a ä q	o p ɛ k a ʔ a ʔ
opo	o p o	o p o
owahie	o w a h ie	o w a h i
paämahaie	p a ä m a h a ie	p a ʔ a m a h a i
pabèoe	p a b è oe	p a b ɛ u
paboedajaq	p a b oe d a j a q	p a b u d a j a ʔ
paböha	p a b ö h a	p a b ɨ h a
padahèboe(w)a	p a d a h è b oe ( w ) a	p a d a h ɛ b u ( w ) a
padaiejaäq	p a d a ie j a ä q	p a d a i j a ʔ a ʔ
padiehoie(j)aqä	p a d ie h o ie ( j ) a qä	p a d i ç o i ( j ) a ʔ a
padiehopie	p a d ie h o p ie	p a d i ç o p i
padiekaä	p a d ie k a ä	p a d i k a ʔ a
padoedoie	p a d oe d o ie	p a d u d o i
padoewaä	p a d oe w a ä	p a d u w a ʔ a
paèdoha	p a è d o h a	p a ɛ d o h a
paèhie	p a è h ie	p a ɛ h i
paèho	p a è h o	p a ɛ h o
paèie	p a è ie	p a ɛ i
paènoe	p a è n oe	p a ɛ n u
pahabieaäq	p a h a b ie a ä q	p a h a b i a ʔ a ʔ
pahaboe(w)ĕ	p a h a b oe ( w ) ĕ	p a h a b u ( w ) ə
pa(ha)böhaq	p a ( h a ) b ö h a q	p a ( h a ) b ɨ h a ʔ
pahadodie(j)aäq	p a h a d o d ie ( j ) a ä q	p a h a d o d i ( j ) a ʔ a ʔ
pahadoho; pahadoho èkiedjaie(j)oe	p a h a d o h o ; # p a h a d o h o # è k ie dj a ie ( j ) oe	p a h a d o h o ; # p a h a d o h o # ɛ k i d͡ʒ a i ( j ) u
pahaèkoe	p a h a è k oe	p a h a ɛ k u
pahakè(j)aq	p a h a k è ( j ) a q	p a h a k ɛ ( j ) a ʔ
pahakie(j)a	p a h a k ie ( j ) a	p a h a k i ( j ) a
pahakoienanaq	p a h a k o ie n a n a q	p a h a k o i n a n a ʔ
pahaö	p a h a ö	p a h a ʔ o
pahapèaq	p a h a p è a q	p a h a p ɛ a ʔ
pahapoeè(q)	p a h a p oe è ( q )	p a h a p u ɛ ( ʔ )
pahjo	p a h j o	p a h j o
pahodaie	p a h o d a ie	p a h o d a i
pahoehoedoe	p a h oe h oe d oe	p a h u h u d u
pahoemana	p a h oe m a n a	p a h u m a n a
pahoeoenaq	p a h oeoe n a q	p a h u ʔ u n a ʔ
pahoqoekie	p a h o q oe k ie	p a h o ʔ u k i
pahoraie	p a h o r a ie	p a h o r a i
paienènèaq	p a ie n è n è a q	p a i n ɛ n ɛ a ʔ
pakahadè	p a k a h a d è	p a k a h a d ɛ
pakahopa	p a k a h o p a	p a k a h o p a
pakaö(w)aq	p a k a ö ( w ) a q	p a k a ʔ o ( w ) a ʔ
pakarahaq	p a k a r a h a q	p a k a r a h a ʔ
pakèho(w)oq	p a k è h o ( w ) o q	p a k ɛ h o ( w ) o ʔ
pakè(j)aq	p a k è ( j ) a q	p a k ɛ ( j ) a ʔ
pakèlie(j)a	p a k è l ie ( j ) a	p a k ɛ l i ( j ) a
pakie(j)oe	p a k ie ( j ) oe	p a k i ( j ) u
pakiemaha	p a k ie m a h a	p a k i m a h a
pakieno	p a k ie n o	p a k i n o
pakieopo	p a k ie o p o	p a k i o p o
pakoba	p a k o b a	p a k o b a
pakoehè	p a k oe h è	p a k u h ɛ
pakoehie(j)aq	p a k oe h ie ( j ) a q	p a k u h i ( j ) a ʔ
pakoehö(j)aq	p a k oe h ö ( j ) a q	p a k u h ɨ ( j ) a ʔ
pakoeienanaq	p a k oe ie n a n a q	p a k u i n a n a ʔ
pakoenaq	p a k oe n a q	p a k u n a ʔ
kèo pakoenaq aiekiedjaieboe	k è o # p a k oe n a q # a ie k ie dj a ie b oe	k ɛ o # p a k u n a ʔ # a i k i d͡ʒ a i b u
pakoenoejo	p a k oe n oe j o	p a k u n u j o
pakoeoe(w)aq	p a k oeoe ( w ) a q	p a k u ʔ u ( w ) a ʔ
pakoepèq	p a k oe p è q	p a k u p ɛ ʔ
pakoe(w)aq	p a k oe ( w ) a q	p a k u ( w ) a ʔ
pakohaq	p a k o h a q	p a k o h a ʔ
pako(q)öhaäq	p a k o ( q ) ö h a ä q	p a k o ( ʔ ) ɨ h a ʔ a ʔ
pako(w)èhko(w)èh	p a k o ( w ) è h k o ( w ) è h	p a k o ( w ) ɛ h k o ( w ) ɛ h
pamahaoema	p a m a h a oe m a	p a m a h a u m a
pamahona	p a m a h o n a	p a m a h o n a
pamèmèho	p a m è m è h o	p a m ɛ m ɛ h o
pana(h)	p a n a ( h )	p a n a ( h )
panako	p a n a k o	p a n a k o
panakona	p a n a k o n a	p a n a k o n a
kie(j)abaq panakona	k ie ( j ) a b a q # p a n a k o n a	k i ( j ) a b a ʔ # p a n a k o n a
panakonaäq	p a n a k o n a ä q	p a n a k o n a ʔ a ʔ
panaoe	p a n a oe	p a n a u
panapa	p a n a p a	p a n a p a
panè	p a n è	p a n ɛ
hopanè	h o p a n è	h o p a n ɛ
panènèhaie	p a n è n è h a ie	p a n ɛ n ɛ h a i
panieha(q)	p a n ie h a ( q )	p a n i ç a ( ʔ )
paodèaq	p a o d è a q	p a o d ɛ a ʔ
paoeho(q)	p a oe h o ( q )	p a u h o ( ʔ )
paoe(w)a	p a oe ( w ) a	p a u ( w ) a
paoe(w)aoe	p a oe ( w ) a oe	p a u ( w ) a u
paopajaäq	p a o p a j a ä q	p a o p a j a ʔ a ʔ
paopèkie(j)aq	p a o p è k ie ( j ) a q	p a o p ɛ k i ( j ) a ʔ
papa	p a p a	p a p a
papĕrabie	p a p ĕ r a b ie	p a p ə r a b i
papèa	p a p è a	p a p ɛ a
papèhodie	p a p è h o d ie	p a p ɛ h o d i
papoedoe	p a p oe d oe	p a p u d u
paqjo	p a q j o	p a ʔ j o
parabie	p a r a b ie	p a r a b i
parahoeie	p a r a h oe ie	p a r a h u i
parako(w)a	p a r a k o ( w ) a	p a r a k o ( w ) a
pariehoie(j)aqä	p a r ie h o ie ( j ) a qä	p a r i ç o i ( j ) a ʔ a
pariepoepoeh	p a r ie p oe p oe h	p a r i p u p u h
parieqö	p a r ie q ö	p a r i ʔ ɨ
paroepèie	p a r oe p è ie	p a r u p ɛ i
paroähaja	p a r o ä h a j a	p a r o ʔ a h a j a
parobiekie	p a r o b ie k ie	p a r o b i k i
paroriepo	p a r o r ie p o	p a r o r i p o
pè	p è	p ɛ
haboepè	h a b oe p è	h a b u p ɛ
pè(j)aha	p è ( j ) a h a	p ɛ ( j ) a h a
pĕkaka	p ĕ k a k a	p ə k a k a
pĕkakarie(j)aq	p ĕ k a k a r ie ( j ) a q	p ə k a k a r i ( j ) a ʔ
pènjako	p è nj a k o	p ɛ ɲ a k o
pènohie(j)o	p è n o h ie ( j ) o	p ɛ n o h i ( j ) o
piehie	p ie h ie	p i ç i
pie(j)ako(w)èq	p ie ( j ) a k o ( w ) è q	p i ( j ) a k o ( w ) ɛ ʔ
piekie(j)aq	p ie k ie ( j ) a q	p i k i ( j ) a ʔ
piekopieko	p ie k o p ie k o	p i k o p i k o
piekoöie	p ie k o ö ie	p i k o ʔ o i
pienahaäq	p ie n a h a ä q	p i n a h a ʔ a ʔ
pieöhaäq	p ie ö h a ä q	p i ʔ o h a ʔ a ʔ
piepienaq	p ie p ie n a q	p i p i n a ʔ
poedaq	p oe d a q	p u d a ʔ
poedarie	p oe d a r ie	p u d a r i
poekoie	p oe k o ie	p u k o i
poeoenjaq	p oeoe nj a q	p u ʔ u ɲ a ʔ
poepoedoe	p oe p oe d oe	p u p u d u
poeqä	p oe qä	p u ʔ a
poerieho	p oe r ie h o	p u r i ç o
pohaie	p o h a ie	p o h a i
pohoie(j)aoda	p o h o ie ( j ) a o d a	p o h o i ( j ) a o d a
pöhöjaq	p ö h ö j a q	p ɨ h ɨ j a ʔ
pöhöjaq	p ö h ö j a q	p ɨ h ɨ j a ʔ
poporo	p o p o r o	p o p o r o
poöpèkie(j)aq	p o ö p è k ie ( j ) a q	p o ʔ o p ɛ k i ( j ) a ʔ
radjo	r a dj o	r a d͡ʒ o
rapat	r a p a t	r a p a t
taka	t a k a	t a k a
tjientjien	tj ie n tj ie n	t͡ʃ i n t͡ʃ i n
wakiepörö	w a k ie p ö r ö	w a k i p ɨ r ɨ
(è)kahaèq	( è ) k a h a è q	( ɛ ) k a h a ɛ ʔ
adoe(w)a	a d oe ( w ) a	a d u ( w ) a
akoloe	a k o l oe	a k o l u
a(o)pa	a ( o ) p a	a ( o ) p a
adieba	a d ie b a	a d i b a
akieäkiena	a k ie ä k ie n a	a k i ʔ a k i n a
adieba hie adoe(w)a	a d ie b a # h ie # a d oe ( w ) a	a d i b a # h i # a d u ( w ) a
arieba hie aroe(w)a	a r ie b a # h ie # a r oe ( w ) a	a r i b a # h i # a r u ( w ) a
aliebĕ hie adoe(w)ĕ	a l ie b ĕ # h ie # a d oe ( w ) ĕ	a l i b ə # h i # a d u ( w ) ə
a(o)pa hie a(o)pa	a ( o ) p a # h ie # a ( o ) p a	a ( o ) p a # h i # a ( o ) p a
abaiekahaèq	a b a ie k a h a è q	a b a i k a h a ɛ ʔ
kiepa(a)oeq	k ie p a ( a ) oe q	k i p a ( a ) u ʔ
kiepa(a)oeq hie (è)kahaèq	k ie p a ( a ) oe q # h ie # ( è ) k a h a è q	k i p a ( a ) u ʔ # h i # ( ɛ ) k a h a ɛ ʔ
kiepa(a)oeq hie adoe(w)a	k ie p a ( a ) oe q # h ie # a d oe ( w ) a	k i p a ( a ) u ʔ # h i # a d u ( w ) a
kiepa(a)oeq hie aroe(w)a	k ie p a ( a ) oe q # h ie # a r oe ( w ) a	k i p a ( a ) u ʔ # h i # a r u ( w ) a
kiepa(a)oeq hie adoe(w)ĕ	k ie p a ( a ) oe q # h ie # a d oe ( w ) ĕ	k i p a ( a ) u ʔ # h i # a d u ( w ) ə
(è)kahaèq taka	( è ) k a h a è q # t a k a	( ɛ ) k a h a ɛ ʔ # t a k a
(è)kahaèq taka hie (è)kahaèq	( è ) k a h a è q # t a k a # h ie # ( è ) k a h a è q	( ɛ ) k a h a ɛ ʔ # t a k a # h i # ( ɛ ) k a h a ɛ ʔ
(è)kahaèq taka hie kiepa(a)oeq	( è ) k a h a è q # t a k a # h ie # k ie p a ( a ) oe q	( ɛ ) k a h a ɛ ʔ # t a k a # h i # k i p a ( a ) u ʔ
(è)kahaèq taka hie kiepa(a)oeq, hie (è)kahaèq	( è ) k a h a è q # t a k a # h ie # k ie p a ( a ) oe q , # h ie # ( è ) k a h a è q	( ɛ ) k a h a ɛ ʔ # t a k a # h i # k i p a ( a ) u ʔ , # h i # ( ɛ ) k a h a ɛ ʔ
adoe(w)a taka	a d oe ( w ) a # t a k a	a d u ( w ) a # t a k a
aroe(w)a taka	a r oe ( w ) a # t a k a	a r u ( w ) a # t a k a
adoe(w)ĕ taka	a d oe ( w ) ĕ # t a k a	a d u ( w ) ə # t a k a
adoe(w)a taka hie (è)kahaèq	a d oe ( w ) a # t a k a # h ie # ( è ) k a h a è q	a d u ( w ) a # t a k a # h i # ( ɛ ) k a h a ɛ ʔ
aroe(w)a taka hie (è)kahaèq	a r oe ( w ) a # t a k a # h ie # ( è ) k a h a è q	a r u ( w ) a # t a k a # h i # ( ɛ ) k a h a ɛ ʔ
adoe(w)ĕ taka hie (è)kahaèq	a d oe ( w ) ĕ # t a k a # h ie # ( è ) k a h a è q	a d u ( w ) ə # t a k a # h i # ( ɛ ) k a h a ɛ ʔ
adoe(w)a taka hie kiepa(a)oeq	a d oe ( w ) a # t a k a # h ie # k ie p a ( a ) oe q	a d u ( w ) a # t a k a # h i # k i p a ( a ) u ʔ
aroe(w)a taka hie kiepa(a)oeq	a r oe ( w ) a # t a k a # h ie # k ie p a ( a ) oe q	a r u ( w ) a # t a k a # h i # k i p a ( a ) u ʔ
adoe(w)ĕ taka hie kiepa(a)oeq	a d oe ( w ) ĕ # t a k a # h ie # k ie p a ( a ) oe q	a d u ( w ) ə # t a k a # h i # k i p a ( a ) u ʔ
akaloe taka	a k a l oe # t a k a	a k a l u # t a k a
akoloe taka hie kiepa(a)oeq	a k o l oe # t a k a # h ie # k ie p a ( a ) oe q	a k o l u # t a k a # h i # k i p a ( a ) u ʔ
a(o)pa taka	a ( o ) p a # t a k a	a ( o ) p a # t a k a
a(o)fa taka	a ( o ) f a # t a k a	a ( o ) f a # t a k a
a(o)pa taka hie kiepa(a)oeq	a ( o ) p a # t a k a # h ie # k ie p a ( a ) oe q	a ( o ) p a # t a k a # h i # k i p a ( a ) u ʔ
a(o)fa taka hie kiepa(a)oeq	a ( o ) f a # t a k a # h ie # k ie p a ( a ) oe q	a ( o ) f a # t a k a # h i # k i p a ( a ) u ʔ
adieba taka	a d ie b a # t a k a	a d i b a # t a k a
arieba taka	a r ie b a # t a k a	a r i b a # t a k a
aliebĕ taka	a l ie b ĕ # t a k a	a l i b ə # t a k a
kiepa(a)oeq taka	k ie p a ( a ) oe q # t a k a	k i p a ( a ) u ʔ # t a k a
kiefa(a)oeq taka	k ie f a ( a ) oe q # t a k a	k i f a ( a ) u ʔ # t a k a
(è)kahaèq koedodoka	( è ) k a h a è q # k oe d o d o k a	( ɛ ) k a h a ɛ ʔ # k u d o d o k a
