originals	tokenized	transliterated
aääoe	a ä ä oe	a ' a ʔ a u
aäpoe(w)a(q)	a ä p oe ( w ) a ( q )	a ' a p u ( w ) a ( ' )
aba	a b a	a b a
abaiekahaieq	a b a ie k a h a ie q	a b a i k a h a i '
abakoe(w)a(q)	a b a k oe ( w ) a ( q )	a b a k u ( w ) a ( ' )
abaoe(w)aie(j)onie(j)a	a b a oe ( w ) a ie ( j ) o n ie ( j ) a	a b a u ( w ) a i ( j ) o n i ( j ) a
abapoe(w)apaoe(w)a	a b a p oe ( w ) a p a oe ( w ) a	a b a p u ( w ) a p a u ( w ) a
abèha	a b è h a	a b E h a
abèo	a b è o	a b E o
aboeaqä	a b oe a qä	a b u a ' a
aböha	a b ö h a	a b u̇ h a
adèq	a d è q	a d E '
adie	a d ie	a d i
adieba	a d ie b a	a d i b a
adieba hie adoe(w)a	a d ie b a # h ie # a d oe ( w ) a	a d i b a # h i # a d u ( w ) a
ado	a d o	a d o
adoe(w)a	a d oe ( w ) a	a d u ( w ) a
ahadie	a h a d ie	a h a d i
ahado	a h a d o	a h a d o
ahapieorie	a h a p ie o r ie	a h a p i o r i
ahapoie	a h a p o ie	a h a p o i
aharie	a h a r ie	a h a r i
aharieohoie	a h a r ie o h o ie	a h a r i o h o i
ahèmoie	a h è m o ie	a h E m o i
ahiebie	a h ie b ie	a h i b i
ahiemahona	a h ie m a h o n a	a h i m a h o n a
ahopaq	a h o p a q	a h o p a '
aieiejo	a ie ie j o	a i i j o
aiekoie	a ie k o ie	a i k o i
aiekoie(j)aq	a ie k o ie ( j ) a q	a i k o i ( j ) a '
ajoqoie	a j o q o ie	a j o ' o i
akieäkiena	a k ie ä k ie n a	a k i ' a k i n a
akiedaq	a k ie d a q	a k i d a '
akiedaqöö	a k ie d a q ö ö	a k i d a ' u̇ u̇
oe(w)aho bakiekiedaq	oe ( w ) a h o # b a k ie k ie d a q	u ( w ) a h o # b a k i k i d a '
akiehaäq	a k ie h a ä q	a k i h a ' a '
akienaie	a k ie n a ie	a k i n a i
akohaie; maäkohaie	a k o h a ie ; # m a ä k o h a ie	a k o h a i ; # m a ' a k o h a i
akoloe	a k o l oe	a k o l u
ama	a m a	a m a
amahèaqja	a m a h è a q j a	a m a h E a ' j a
amanaie	a m a n a ie	a m a n a i
amĕnaq	a m ĕ n a q	a m ė n a '
amĕno	a m ĕ n o	a m ė n o
amèq	a m è q	a m E '
amoeapo	a m oe a p o	a m u a p o
amoehoe; èienoeqoe(q)	a m oe h oe ; # è ie n oe q oe ( q )	a m u h u ; # E i n u ' u ( ' )
èkariehie	è k a r ie h ie	E k a r i h i
èkienè	è k ie n è	E k i n E
ana	a n a	a n a
aniemaie	a n ie m a ie	a n i m a i
anoekoöq	a n oe k o ö q	a n u k o ' o '
anohakèkè	a n o h a k è k è	a n o h a k E k E
anoqö	a n o q ö	a n o ' u̇
anokè	a n o k è	a n o k E
anokie	a n o k ie	a n o k i
anoöho	a n o ö h o	a n o ' o h o
anoqè(j)a	a n o q è ( j ) a	a n o ' E ( j ) a
aoe	a oe	a u
aoedoe	a oe d oe	a u d u
a(o)pa	a ( o ) p a	a ( o ) p a
a(o)pahiea(o)pa	a ( o ) p a h ie a ( o ) p a	a ( o ) p a h i a ( o ) p a
apieaie	a p ie a ie	a p i a i
a(p)ie(j)aka	a ( p ) ie ( j ) a k a	a ( p ) i ( j ) a k a
kie(a)pie(j)aka	k ie ( a ) p ie ( j ) a k a	k i ( a ) p i ( j ) a k a
apienie	a p ie n ie	a p i n i
apoie	a p o ie	a p o i
apoie	a p o ie	a p o i
aroekoe(w)a	a r oe k oe ( w ) a	a r u k u ( w ) a
aroekoe(w)a è(a)karoba	a r oe k oe ( w ) a # è ( a ) k a r o b a	a r u k u ( w ) a # E ( a ) k a r o b a
aroeoeieoe(w)a	a r oeoe ie oe ( w ) a	a r u ' u i u ( w ) a
awa(h)	a w a ( h )	a w a ( h )
awanaq	a w a n a q	a w a n a '
ba(a)oe(w)a	b a ( a ) oe ( w ) a	b a ( a ) u ( w ) a
baba; oebaba	b a b a ; # oe b a b a	b a b a ; # u b a b a
baba; oebaba	b a b a ; # oe b a b a	b a b a ; # u b a b a
badjoe	b a dj oe	b a j u
bahabaieba	b a h a b a ie b a	b a h a b a i b a
bahora	b a h o r a	b a h o r a
baoe(w)adie	b a oe ( w ) a d ie	b a u ( w ) a d i
barieboerieboe	b a r ie b oe r ie b oe	b a r i b u r i b u
bĕlie(j)oeng	b ĕ l ie ( j ) oe n g	b ė l i ( j ) u n g
bĕnang	b ĕ n a n g	b ė n a n g
biedie	b ie d ie	b i d i
boe	b oe	b u
boe	b oe	b u
boeboeqie	b oe b oe q ie	b u b u ' i
boedahiejaq	b oe d a h ie j a q	b u d a h i j a '
boeodo	b oe o d o	b u o d o
boeodo	b oe o d o	b u o d o
dadoe(oe)	d a d oe ( oe )	d a d u ( u )
daiekahadie(j)a	d a ie k a h a d ie ( j ) a	d a i k a h a d i ( j ) a
dajo	d a j o	d a j o
daraqie	d a r a q ie	d a r a ' i
dètar	d è t a r	d E t a r
die(j)a	d ie ( j ) a	d i ( j ) a
dja(ä)oe(w)a	dj a ( ä ) oe ( w ) a	j a ( ' a ) u ( w ) a
dodo	d o d o	d o d o
dödöhöka	d ö d ö h ö k a	d u̇ d u̇ h u̇ k a
dodokaqäq	d o d o k a qä q	d o d o k a ' a '
è	è	E
èa	è a	E a
èa	è a	E a
èaähaie	è a ä h a ie	E a ' a h a i
èaä(h)ko	è a ä ( h ) k o	E a ' a ( h ) k o
maä(h)ko	m a ä ( h ) k o	m a ' a ( h ) k o
èa(ä)haoie	è a ( ä ) h a o ie	E a ( ' a ) h a o i
èaäkoe	è a ä k oe	E a ' a k u
èaäkoha	è a ä k o h a	E a ' a k o h a
èaäoe	è a ä oe	E a ' a u
èaäq	è a ä q	E a ' a '
èabaä	è a b a ä	E a b a ' a
èabaäo	è a b a ä o	E a b a ' a o
èabadie(j)o	è a b a d ie ( j ) o	E a b a d i ( j ) o
èabaoekiedaie	è a b a oe k ie d a ie	E a b a u k i d a i
èabaoe(w)a	è a b a oe ( w ) a	E a b a u ( w ) a
èabo	è a b o	E a b o
èaboebaja	è a b oe b a j a	E a b u b a j a
èadahohoe	è a d a h o h oe	E a d a h o h u
èadieho	è a d ie h o	E a d i h o
èadoe(w)a	è a d oe ( w ) a	E a d u ( w ) a
èadoö(w)ie	è a d o ö ( w ) ie	E a d o ' o ( w ) i
èaèkaboe	è a è k a b oe	E a E k a b u
èahabaoeda	è a h a b a oe d a	E a h a b a u d a
èahaboe(w)a	è a h a b oe ( w ) a	E a h a b u ( w ) a
èahaie	è a h a ie	E a h a i
èahaienjoqä	è a h a ie nj o qä	E a h a i ñ o ' a
èahaoedohoie	è a h a oe d o h o ie	E a h a u d o h o i
èahèdie(j)a	è a h è d ie ( j ) a	E a h E d i ( j ) a
èahoepoq	è a h oe p o q	E a h u p o '
èahopè	è a h o p è	E a h o p E
èaie	è a ie	E a i
èajo	è a j o	E a j o
èakakoq	è a k a k o q	E a k a k o '
èanaöa	è a n a ö a	E a n a ' o a
èaoeno	è a oe n o	E a u n o
èawieka	è a w ie k a	E a w i k a
èboeboe	è b oe b oe	E b u b u
èhaie(j)oeĕq	è h a ie ( j ) oe ĕ q	E h a i ( j ) u ė '
èhèjog	è h è j o g	E h E j o g
è(j)anoqäq	è ( j ) a n o qä q	E ( j ) a n o ' a '
èkabaroekoe	è k a b a r oe k oe	E k a b a r u k u
èkahaie(j)abie	è k a h a ie ( j ) a b ie	E k a h a i ( j ) a b i
èkahoro	è k a h o r o	E k a h o r o
èkaiedodo	è k a ie d o d o	E k a i d o d o
èkapaqie(j)o	è k a p a q ie ( j ) o	E k a p a ' i ( j ) o
èkaqoe(w)aie	è k a q oe ( w ) a ie	E k a ' u ( w ) a i
èkieoedahjo	è k ie oe d a h j o	E k i u d a h j o
èkieoedie	è k ie oe d ie	E k i u d i
èkietaäpoe(w)aq	è k ie t a ä p oe ( w ) a q	E k i t a ' a p u ( w ) a '
èkoe(w)èq	è k oe ( w ) è q	E k u ( w ) E '
èloietjaq	è l o ie tj a q	E l o i c a '
èmoenèqä	è m oe n è qä	E m u n E ' a
èokoödoq	è o k o ö d o q	E o k o ' o d o '
èpaoe(w)oko	è p a oe ( w ) o k o	E p a u ( w ) o k o
èkanawèq	è k a n a w è q	E k a n a w E '
èkèma	è k è m a	E k E m a
èakadie(j)o	è a k a d ie ( j ) o	E a k a d i ( j ) o
èakaka	è a k a k a	E a k a k a
èakakaie	è a k a k a ie	E a k a k a i
èakano	è a k a n o	E a k a n o
è(a)karoba	è ( a ) k a r o b a	E ( a ) k a r o b a
èakieakie	è a k ie a k ie	E a k i a k i
èakieie	è a k ie ie	E a k i i
èakomaq	è a k o m a q	E a k o m a '
èamaha	è a m a h a	E a m a h a
èamajoq	è a m a j o q	E a m a j o '
èamaniekie	è a m a n ie k ie	E a m a n i k i
èamè	è a m è	E a m E
èamieamie	è a m ie a m ie	E a m i a m i
èana	è a n a	E a n a
èanèka	è a n è k a	E a n E k a
èanèha	è a n è h a	E a n E h a
èanokanie	è a n o k a n ie	E a n o k a n i
èanonöoe	è a n o n ö oe	E a n o n u̇ u
èaoedahohoe	è a oe d a h o h oe	E a u d a h o h u
èaoekaä	è a oe k a ä	E a u k a ' a
èaohaq	è a o h a q	E a o h a '
èaokieie	è a o k ie ie	E a o k i i
èapakoe	è a p a k oe	E a p a k u
èapama	è a p a m a	E a p a m a
èapaq	è a p a q	E a p a '
èapara	è a p a r a	E a p a r a
èapo	è a p o	E a p o
èapoe	è a p oe	E a p u
èapoe èkoe(w)o	è a p oe # è k oe ( w ) o	E a p u # E k u ( w ) o
èapoeaka	è a p oe a k a	E a p u a k a
èapoeq	è a p oe q	E a p u '
èapoie	è a p o ie	E a p o i
èa(q)	è a ( q )	E a ( ' )
èara	è a r a	E a r a
èara: èhöda	è a r a : # è h ö d a	E a r a : # E h u̇ d a
èmanie	è m a n ie	E m a n i
(oe)èkieho	( oe ) è k ie h o	( u ) E k i h o
(oe)kieadoboe	( oe ) k ie a d o b oe	( u ) k i a d o b u
(oe)wabèha	( oe ) w a b è h a	( u ) w a b E h a
(oe)äie	( oe ) ä ie	( u ) ' a i
(oe)apo	( oe ) a p o	( u ) a p o
baära	b a ä r a	b a ' a r a
èaraboeka	è a r a b oe k a	E a r a b u k a
èaraqko(w)a	è a r a q k o ( w ) a	E a r a ' k o ( w ) a
èaroekèrè	è a r oe k è r è	E a r u k E r E
èaroe(w)a	è a r oe ( w ) a	E a r u ( w ) a
èaroja	è a r o j a	E a r o j a
èaropa	è a r o p a	E a r o p a
èaroqä	è a r o qä	E a r o ' a
èatjara	è a tj a r a	E a c a r a
èawaq	è a w a q	E a w a '
èba	è b a	E b a
èbaba	è b a b a	E b a b a
èbadjiedjo	è b a dj ie dj o	E b a j i j o
èbaho	è b a h o	E b a h o
èbaie	è b a ie	E b a i
èbaka	è b a k a	E b a k a
èbaka: (è)oewè	è b a k a : # ( è ) oe w è	E b a k a : # ( E ) u w E
(oe)kahaoq	( oe ) k a h a o q	( u ) k a h a o '
(oe)kiedjaie	( oe ) k ie dj a ie	( u ) k i j a i
(oe)kokoq	( oe ) k o k o q	( u ) k o k o '
(oe)oemo	( oe ) oe m o	( u ) u m o
èbaoe	è b a oe	E b a u
èbèlo(w)a	è b è l o ( w ) a	E b E l o ( w ) a
èbèo	è b è o	E b E o
èbiehoe	è b ie h oe	E b i h u
èbie(j)oe	è b ie ( j ) oe	E b i ( j ) u
èbo	è b o	E b o
èboeèparaqwo	è b oe è p a r a q w o	E b u E p a r a ' w o
èboe(w)è	è b oe ( w ) è	E b u ( w ) E
èboqaboqa	è b o q a b o q a	E b o ' a b o ' a
èdaba	è d a b a	E d a b a
èdaboeho	è d a b oe h o	E d a b u h o
èdaboeho	è d a b oe h o	E d a b u h o
èadoho	è a d o h o	E a d o h o
èaroiepoko	è a r o ie p o k o	E a r o i p o k o
èbaka	è b a k a	E b a k a
èie(j)oeh	è ie ( j ) oe h	E i ( j ) u h
èkarèpè(h)	è k a r è p è ( h )	E k a r E p E ( h )
èkiedjaie	è k ie dj a ie	E k i j a i
èoedoe	è oe d oe	E u d u
èoekaq	è oe k a q	E u k a '
èpaö	è p a ö	E p a ' o
èdado; èdadoèoedoe	è d a d o ; # è d a d oè oe d oe	E d a d o ; # E d a d u u d u
èdahajo	è d a h a j o	E d a h a j o
èdahèboeäo	è d a h è b oe ä o	E d a h E b u ' a o
èdakohaq	è d a k o h a q	E d a k o h a '
èdèabo	è d è a b o	E d E a b o
èdiehao	è d ie h a o	E d i h a o
èdiehie(j)oq	è d ie h ie ( j ) o q	E d i h i ( j ) o '
èdieho	è d ie h o	E d i h o
èdie(j)a	è d ie ( j ) a	E d i ( j ) a
èdie(j)o	è d ie ( j ) o	E d i ( j ) o
èdieie(j)o	è d ie ie ( j ) o	E d i i ( j ) o
èdie(j)oe(w)aka	è d ie ( j ) oe ( w ) a k a	E d i ( j ) u ( w ) a k a
èdie(j)oewaoekèdjajoe	è d ie ( j ) oe w a oe k è dj a j oe	E d i ( j ) u w a u k E j a j u
èdiekieho	è d ie k ie h o	E d i k i h o
èdiekoeroe	è d ie k oe r oe	E d i k u r u
èdieoboe; èdieoboedie(j)ĕ	è d ie o b oe ; # è d ie o b oe d ie ( j ) ĕ	E d i o b u ; # E d i o b u d i ( j ) ė
èdoboe	è d o b oe	E d o b u
èdoboe kanapoe(w)a	è d o b oe # k a n a p oe ( w ) a	E d o b u # k a n a p u ( w ) a
èdodie	è d o d ie	E d o d i
èdoehoekie(j)aq	è d oe h oe k ie ( j ) a q	E d u h u k i ( j ) a '
èdohaie	è d o h a ie	E d o h a i
èdohoie	è d o h o ie	E d o h o i
kiedohoie	k ie d o h o ie	k i d o h o i
èdolèdolè	è d o l è d o l è	E d o l E d o l E
èdoöa	è d o ö a	E d o ' o a
èdoöraoe	è d o ö r a oe	E d o ' o r a u
èdopo	è d o p o	E d o p o
èdopodopo	è d o p o d o p o	E d o p o d o p o
èdoro	è d o r o	E d o r o
èè	è è	E E
èèbaè	è è b a è	E E b a E
èèdako	è è d a k o	E E d a k o
èèèno	è è è n o	E E E n o
èèhè	è è h è	E E h E
èèho	è è h o	E E h o
èèhöa	è è h ö a	E E h u̇ a
èè(j)aq	è è ( j ) a q	E E ( j ) a '
èèkadjie(j)a	è è k a dj ie ( j ) a	E E k a j i ( j ) a
èèko	è è k o	E E k o
èèlo	è è l o	E E l o
èèmaha	è è m a h a	E E m a h a
èèna	è è n a	E E n a
èènèho	è è n è h o	E E n E h o
èènono; èènono: oepo	è è n o n o ; # è è n o n o : # oe p o	E E n o n o ; # E E n o n o : # u p o
oeèpo	oe è p o	u E p o
èèodie	è è o d ie	E E o d i
èèodieoekoewo	è è o d ie oe k oe w o	E E o d i u k u w o
èèoq	è è o q	E E o '
èèpè	è è p è	E E p E
èèpo	è è p o	E E p o
èhabarie(j)a	è h a b a r ie ( j ) a	E h a b a r i ( j ) a
èhado(q)	è h a d o ( q )	E h a d o ( ' )
èhahadiediekie	è h a h a d ie d ie k ie	E h a h a d i d i k i
èhaiepoe	è h a ie p oe	E h a i p u
èhamo	è h a m o	E h a m o
kiehahamo	k ie h a h a m o	k i h a h a m o
èhamoa	è h a m o a	E h a m o a
èhanoe(w)a	è h a n oe ( w ) a	E h a n u ( w ) a
èhao	è h a o	E h a o
èharobèao	è h a r o b è a o	E h a r o b E a o
èharoeq	è h a r oe q	E h a r u '
èhèapo	è h è a p o	E h E a p o
èhèboe	è h è b oe	E h E b u
èhèie(j)o	è h è ie ( j ) o	E h E i ( j ) o
èhèja	è h è j a	E h E j a
èhèkoe(q)	è h è k oe ( q )	E h E k u ( ' )
mahèkoe(q)	m a h è k oe ( q )	m a h E k u ( ' )
èhèkoe(q)wa	è h è k oe ( q ) w a	E h E k u ( ' ) w a
èhèla	è h è l a	E h E l a
kèo hèla	k è o # h è l a	k E o # h E l a
èhèoe(w)a	è h è oe ( w ) a	E h E u ( w ) a
èhèoe(w)è	è h è oe ( w ) è	E h E u ( w ) E
èhè(q)ie(j)oe	è h è ( q ) ie ( j ) oe	E h E ( ' ) i ( j ) u
èhèrie(j)a	è h è r ie ( j ) a	E h E r i ( j ) a
èhie(j)o	è h ie ( j ) o	E h i ( j ) o
èhoa	è h o a	E h o a
èhöadie	è h ö a d ie	E h u̇ a d i
mahöadie	m a h ö a d ie	m a h u̇ a d i
èhoanie	è h o a n ie	E h o a n i
èho(w)apo	è h o ( w ) a p o	E h o ( w ) a p o
èhoboe	è h o b oe	E h o b u
èhöda	è h ö d a	E h u̇ d a
èhoekoe	è h oe k oe	E h u k u
èhoe(w)a	è h oe ( w ) a	E h u ( w ) a
èhoka	è h o k a	E h o k a
èhokaie	è h o k a ie	E h o k a i
èhoka(q)	è h o k a ( q )	E h o k a ( ' )
èhokoe	è h o k oe	E h o k u
èhopo	è h o p o	E h o p o
èhoqä	è h o qä	E h o ' a
èhora	è h o r a	E h o r a
èhowaie	è h o w a ie	E h o w a i
èie	è ie	E i
èieboe	è ie b oe	E i b u
èiedjie	è ie dj ie	E i j i
aiedjie	a ie dj ie	a i j i
èieha	è ie h a	E i h a
èieie	è ie ie	E i i
èieieoedoe	è ie ie oe d oe	E i i u d u
èie(j)aoe	è ie ( j ) a oe	E i ( j ) a u
èie(j)ĕ	è ie ( j ) ĕ	E i ( j ) ė
èie(j)oba	è ie ( j ) o b a	E i ( j ) o b a
èie(j)oedopo	è ie ( j ) oe d o p o	E i ( j ) u d o p o
èie(j)oöboöie	è ie ( j ) o ö b o ö ie	E i ( j ) o ' o b o ' o i
èienoeqoe(q)	è ie n oe q oe ( q )	E i n u ' u ( ' )
èienoeqoeie	è ie n oe q oe ie	E i n u ' u i
èiepo	è ie p o	E i p o
èietjo	è ie tj o	E i c o
è(j)adamaie	è ( j ) a d a m a ie	E ( j ) a d a m a i
è(j)aha	è ( j ) a h a	E ( j ) a h a
è(j)ahakoqie	è ( j ) a h a k o q ie	E ( j ) a h a k o ' i
è(j)ahaoeobie	è ( j ) a h a oe o b ie	E ( j ) a h a u o b i
è(j)ahèaqaq	è ( j ) a h è a q a q	E ( j ) a h E a ' a '
è(j)akoqä	è ( j ) a k o qä	E ( j ) a k o ' a
è(j)akoro(w)a	è ( j ) a k o r o ( w ) a	E ( j ) a k o r o ( w ) a
è(j)aniemaie	è ( j ) a n ie m a ie	E ( j ) a n i m a i
è(j)aqètoka	è ( j ) a q è t o k a	E ( j ) a ' E t o k a
è(j)araq	è ( j ) a r a q	E ( j ) a r a '
è(j)araq noeha	è ( j ) a r a q # n oe h a	E ( j ) a r a ' # n u h a
è(j)obie	è ( j ) o b ie	E ( j ) o b i
ĕ(j)opoko	ĕ ( j ) o p o k o	ė ( j ) o p o k o
èkaä	è k a ä	E k a ' a
èkabaiedoq	è k a b a ie d o q	E k a b a i d o '
èkabaieka	è k a b a ie k a	E k a b a i k a
èkabakè	è k a b a k è	E k a b a k E
èkabakèka	è k a b a k è k a	E k a b a k E k a
èkaboeäjo	è k a b oe ä j o	E k a b u ' a j o
èkadaboeqä	è k a d a b oe qä	E k a d a b u ' a
èkadaha(q)	è k a d a h a ( q )	E k a d a h a ( ' )
èkadieodie	è k a d ie o d ie	E k a d i o d i
èkadieopè	è k a d ie o p è	E k a d i o p E
èkadodo(q)	è k a d o d o ( q )	E k a d o d o ( ' )
èkaèn	è k a è n	E k a E n
èkaha	è k a h a	E k a h a
èkahaba	è k a h a b a	E k a h a b a
èkahaèpie	è k a h a è p ie	E k a h a E p i
(è)kahaèq	( è ) k a h a è q	( E ) k a h a E '
èkahanoa	è k a h a n o a	E k a h a n o a
èkahaö	è k a h a ö	E k a h a ' o
èkahaoe	è k a h a oe	E k a h a u
èkahaoekoe	è k a h a oe k oe	E k a h a u k u
èkahaoq	è k a h a o q	E k a h a o '
èkahi(j)oe	è k a h i ( j ) oe	E k a h i ( j ) u
èkahieno(a)	è k a h ie n o ( a )	E k a h i n o ( a )
èkahoe(w)èqo	è k a h oe ( w ) è q o	E k a h u ( w ) E ' o
èkaie	è k a ie	E k a i
èkaieno(h)	è k a ie n o ( h )	E k a i n o ( h )
èkaie(oe)dahoe(hoe)	è k a ie ( oe ) d a h oe ( h oe )	E k a i ( u ) d a h u ( h u )
èkajoqpèdjie	è k a j o q p è dj ie	E k a j o ' p E j i
èkakorèie(j)o	è k a k o r è ie ( j ) o	E k a k o r E i ( j ) o
èkakorè(j)o	è k a k o r è ( j ) o	E k a k o r E ( j ) o
èkamie(j)oe	è k a m ie ( j ) oe	E k a m i ( j ) u
èkanaja	è k a n a j a	E k a n a j a
èkanjoq	è k a nj o q	E k a ñ o '
èkanoa	è k a n o a	E k a n o a
èkanoaie	è k a n o a ie	E k a n o a i
èkanoeoenoe	è k a n oeoe n oe	E k a n u ' u n u
èk(a)oeqpanoe	è k ( a ) oe q p a n oe	E k ( a ) u ' p a n u
èkaoe(w)a	è k a oe ( w ) a	E k a u ( w ) a
èkapahoeka	è k a p a h oe k a	E k a p a h u k a
èkapèlo	è k a p è l o	E k a p E l o
èkapoeh	è k a p oe h	E k a p u h
èka(q)ka(q)	è k a ( q ) k a ( q )	E k a ( ' ) k a ( ' )
èkaraoe(w)ahè	è k a r a oe ( w ) a h è	E k a r a u ( w ) a h E
èkarèpè	è k a r è p è	E k a r E p E
èkarara	è k a r a r a	E k a r a r a
èkarieha	è k a r ie h a	E k a r i h a
èkarieha oe(w)apo	è k a r ie h a # oe ( w ) a p o	E k a r i h a # u ( w ) a p o
oe(w)aie	oe ( w ) a ie	u ( w ) a i
èkèè	è k è è	E k E E
èkèèpa	è k è è p a	E k E E p a
kieèèpa	k ie è è p a	k i E E p a
èkèh(è)	è k è h ( è )	E k E h ( E )
èkèhèodo	è k è h è o d o	E k E h E o d o
èkèkong	è k è k o n g	E k E k o n g
èkèma	è k è m a	E k E m a
èkèoäh	è k è o ä h	E k E o ' a h
èkèoq	è k è o q	E k E o '
èkèponie	è k è p o n ie	E k E p o n i
èkieakie	è k ie a k ie	E k i a k i
èkieakoqä	è k ie a k o qä	E k i a k o ' a
èkieapo	è k ie a p o	E k i a p o
èkiedapè(j)a	è k ie d a p è ( j ) a	E k i d a p E ( j ) a
èkiediebèie(j)oq	è k ie d ie b è ie ( j ) o q	E k i d i b E i ( j ) o '
èkiedjaie	è k ie dj a ie	E k i j a i
èkiedjè	è k ie dj è	E k i j E
èkiedjiekiedjie	è k ie dj ie k ie dj ie	E k i j i k i j i
èkieèèo	è k ie è è o	E k i E E o
ékiehie	é k ie h ie	e k i h i
èkiehie(j)oedo	è k ie h ie ( j ) oe d o	E k i h i ( j ) u d o
èkieho	è k ie h o	E k i h o
èkiehöa	è k ie h ö a	E k i h u̇ a
èkiehoedo	è k ie h oe d o	E k i h u d o
èkiehoedo	è k ie h oe d o	E k i h u d o
èkiehohè(j)a	è k ie h o h è ( j ) a	E k i h o h E ( j ) a
èieha kiehohè(j)a die(j)a	è ie h a # k ie h o h è ( j ) a # d ie ( j ) a	E i h a # k i h o h E ( j ) a # d i ( j ) a
èkieie	è k ie ie	E k i i
èkieie(j)o	è k ie ie ( j ) o	E k i i ( j ) o
èkieie(j)ahaq	è k ie ie ( j ) a h a q	E k i i ( j ) a h a '
èkie(j)aö	è k ie ( j ) a ö	E k i ( j ) a ' o
èkie(j)oe	è k ie ( j ) oe	E k i ( j ) u
èkie(j)oeqie	è k ie ( j ) oe q ie	E k i ( j ) u ' i
èkieka	è k ie k a	E k i k a
èkiekie	è k ie k ie	E k i k i
èkiekohaq	è k ie k o h a q	E k i k o h a '
èkiemo	è k ie m o	E k i m o
èkiemo	è k ie m o	E k i m o
èkienono	è k ie n o n o	E k i n o n o
èkieodoha	è k ie o d o h a	E k i o d o h a
èkietjaho	è k ie tj a h o	E k i c a h o
èkietjoh	è k ie tj o h	E k i c o h
èkietohè	è k ie t o h è	E k i t o h E
èkoanoe	è k o a n oe	E k o a n u
èköaq	è k ö a q	E k u̇ a '
èkodie(j)o	è k o d ie ( j ) o	E k o d i ( j ) o
èkodaäjo	è k o d a ä j o	E k o d a ' a j o
èkoeaka	è k oe a k a	E k u a k a
èkoedodo	è k oe d o d o	E k u d o d o
èkoedodoka	è k oe d o d o k a	E k u d o d o k a
èkoeha	è k oe h a	E k u h a
èkoehie(j)o	è k oe h ie ( j ) o	E k u h i ( j ) o
èkoeka	è k oe k a	E k u k a
èkoeka(oe)waie	è k oe k a ( oe ) w a ie	E k u k a ( u ) w a i
èkoema(q)aoe	è k oe m a ( q ) a oe	E k u m a ( ' ) a u
èkoena	è k oe n a	E k u n a
èkoeöedo	è k oe ö e d o	E k u ' o e d o
èkoepado	è k oe p a d o	E k u p a d o
èkoe(w)abo	è k oe ( w ) a b o	E k u ( w ) a b o
èkoe(w)iekoe(w)ie	è k oe ( w ) ie k oe ( w ) ie	E k u ( w ) i k u ( w ) i
èkoe(w)o	è k oe ( w ) o	E k u ( w ) o
èkohèaq	è k o h è a q	E k o h E a '
èkoh(oie)	è k o h ( o ie )	E k o h ( o i )
èkohoq	è k o h o q	E k o h o '
èkohoqoe(j)obie	è k o h o q oe ( j ) o b ie	E k o h o ' u ( j ) o b i
èkojoq	è k o j o q	E k o j o '
èkokoq	è k o k o q	E k o k o '
èkonienie	è k o n ie n ie	E k o n i n i
kokonienie	k o k o n ie n ie	k o k o n i n i
èkonjoq	è k o nj o q	E k o ñ o '
èkoq	è k o q	E k o '
èkoqä	è k o qä	E k o ' a
èkoqa(j)odie(j)a	è k o q a ( j ) o d ie ( j ) a	E k o ' a ( j ) o d i ( j ) a
èko(q)hajo	è k o ( q ) h a j o	E k o ( ' ) h a j o
èko(ö)qko(ö)q	è k o ( ö ) q k o ( ö ) q	E k o ( ' o ) ' k o ( ' o ) '
èkoq(n)jaoe	è k o q ( n ) j a oe	E k o ' ( n ) j a u
èkoqoeie	è k o q oe ie	E k o ' u i
èkoropie	è k o r o p ie	E k o r o p i
èko(w)a	è k o ( w ) a	E k o ( w ) a
èko(w)èq	è k o ( w ) è q	E k o ( w ) E '
èko(w)èq	è k o ( w ) è q	E k o ( w ) E '
èoe(w)è	è oe ( w ) è	E u ( w ) E
ie(j)akapieta	ie ( j ) a k a p ie t a	i ( j ) a k a p i t a
kaoedara	k a oe d a r a	k a u d a r a
oehoeqkoe(w)o	oe h oe q k oe ( w ) o	u h u ' k u ( w ) o
oewokie	oe w o k ie	u w o k i
èko(w)èq	è k o ( w ) è q	E k o ( w ) E '
èlaäpoe(w)a	è l a ä p oe ( w ) a	E l a ' a p u ( w ) a
èlahaö	è l a h a ö	E l a h a ' o
èmanie	è m a n ie	E m a n i
èlaohoe	è l a o h oe	E l a o h u
èlè	è l è	E l E
èlèaq	è l è a q	E l E a '
èloaba	è l o a b a	E l o a b a
èloha	è l o h a	E l o h a
èmahokakie	è m a h o k a k ie	E m a h o k a k i
èmanie	è m a n ie	E m a n i
èmènahoa	è m è n a h o a	E m E n a h o a
èmèno	è m è n o	E m E n o
èmèo	è m è o	E m E o
èmienoemienoe	è m ie n oe m ie n oe	E m i n u m i n u
èmoamoq	è m o a m o q	E m o a m o '
èmoeoeha	è m oeoe h a	E m u ' u h a
èmomoq	è m o m o q	E m o m o '
èmoöie(j)a	è m o ö ie ( j ) a	E m o ' o i ( j ) a
ènaè(na)	è n a è ( n a )	E n a E ( n a )
ènaè(na): oe(w)apo	è n a è ( n a ) : # oe ( w ) a p o	E n a E ( n a ) : # u ( w ) a p o
oe(w)aie	oe ( w ) a ie	u ( w ) a i
ènana	è n a n a	E n a n a
ènanaoe(w)è	è n a n a oe ( w ) è	E n a n a u ( w ) E
ènapa	è n a p a	E n a p a
ènapienapie	è n a p ie n a p ie	E n a p i n a p i
ènapienie	è n a p ie n ie	E n a p i n i
ènè	è n è	E n E
ènèhèie	è n è h è ie	E n E h E i
ènèanèa	è n è a n è a	E n E a n E a
ènèka	è n è k a	E n E k a
ènieènie(j)a	è n ie è n ie ( j ) a	E n i E n i ( j ) a
ènie(j)o	è n ie ( j ) o	E n i ( j ) o
ènienie	è n ie n ie	E n i n i
ènoä	è n o ä	E n o ' a
ènoeqoeq	è n oe q oe q	E n u ' u '
ènohaie	è n o h a ie	E n o h a i
ènomonomo	è n o m o n o m o	E n o m o n o m o
ènoöhoq	è n o ö h o q	E n o ' o h o '
èoaba	è o a b a	E o a b a
èobo	è o b o	E o b o
èodie	è o d ie	E o d i
apieha èodiedie(j)a	a p ie h a # è o d ie d ie ( j ) a	a p i h a # E o d i d i ( j ) a
èodieaäq	è o d ie a ä q	E o d i a ' a '
bodieaäq	b o d ie a ä q	b o d i a ' a '
kahohodieaäq	k a h o h o d ie a ä q	k a h o h o d i a ' a '
èodieöka	è o d ie ö k a	E o d i ' o k a
èodjie	è o dj ie	E o j i
èodo	è o d o	E o d o
èodöda	è o d ö d a	E o d u̇ d a
èodoe	è o d oe	E o d u
èodohèie	è o d o h è ie	E o d o h E i
èoeba	è oe b a	E u b a
èoeba: èkaèn	è oe b a : # è k a è n	E u b a : # E k a E n
èkieadoboe	è k ie a d o b oe	E k i a d o b u
èkojoq	è k o j o q	E k o j o '
ètèbè	è t è b è	E t E b E
kèèèpa	k è è è p a	k E E E p a
èoeda	è oe d a	E u d a
èoedie	è oe d ie	E u d i
èoedoe	è oe d oe	E u d u
èoedoe bèlo(w)a	è oe d oe # b è l o ( w ) a	E u d u # b E l o ( w ) a
èoeèhè(j)a	è oe è h è ( j ) a	E u E h E ( j ) a
èoehoe	è oe h oe	E u h u
èoeko	è oe k o	E u k o
èoekoe	è oe k oe	E u k u
èoekoeaie	è oe k oe a ie	E u k u a i
èoekoediepo	è oe k oe d ie p o	E u k u d i p o
èoekoeie	è oe k oe ie	E u k u i
èoekoeqoe	è oe k oe q oe	E u k u ' u
èoekoe(w)aie	è oe k oe ( w ) a ie	E u k u ( w ) a i
èoema	è oe m a	E u m a
èoemiehie	è oe m ie h ie	E u m i h i
èoemo	è oe m o	E u m o
èoenèkè	è oe n è k è	E u n E k E
è(oe)noekie(j)o	è ( oe ) n oe k ie ( j ) o	E ( u ) n u k i ( j ) o
èoeoe	è oeoe	E u ' u
èoeoe(w)apo	è oeoe ( w ) a p o	E u ' u ( w ) a p o
èoeoenoe	è oeoe n oe	E u ' u n u
èoepo	è oe p o	E u p o
èoepoeie(j)o	è oe p oe ie ( j ) o	E u p u i ( j ) o
èoepoeqoe(w)o	è oe p oe q oe ( w ) o	E u p u ' u ( w ) o
èoepoe(w)a	è oe p oe ( w ) a	E u p u ( w ) a
èoe(w)a	è oe ( w ) a	E u ( w ) a
èoe(w)aie	è oe ( w ) a ie	E u ( w ) a i
èoe(w)aka	è oe ( w ) a k a	E u ( w ) a k a
èoe(w)apo	è oe ( w ) a p o	E u ( w ) a p o
èoe(w)oho	è oe ( w ) o h o	E u ( w ) o h o
è(o)hora; è(o)horaoekèèpa	è ( o ) h o r a ; # è ( o ) h o r a oe k è è p a	E ( o ) h o r a ; # E ( o ) h o r a u k E E p a
èokaha	è o k a h a	E o k a h a
èokahao	è o k a h a o	E o k a h a o
èokaq	è o k a q	E o k a '
èokie(j)o	è o k ie ( j ) o	E o k i ( j ) o
èoko	è o k o	E o k o
èokoa	è o k o a	E o k o a
èoko(ĕ)	è o k o ( ĕ )	E o k o ( ė )
èokoeh; èokoehèoedoe	è o k oe h ; # è o k oe h è oe d oe	E o k u h ; # E o k u h E u d u
èokohè	è o k o h è	E o k o h E
èokomè	è o k o m è	E o k o m E
èokopie	è o k o p ie	E o k o p i
èokoq	è o k o q	E o k o '
èomo(kie)	è o m o ( k ie )	E o m o ( k i )
èomohoĕ	è o m o h o ĕ	E o m o h o ė
èomona	è o m o n a	E o m o n a
èomoqö	è o m o q ö	E o m o ' u̇
èonokĕ	è o n o k ĕ	E o n o k ė
èononie	è o n o n ie	E o n o n i
èoöbaq	è o ö b a q	E o ' o b a '
èoöbo	è o ö b o	E o ' o b o
èoöboq	è o ö b o q	E o ' o b o '
èoökie	è o ö k ie	E o ' o k i
èopa	è o p a	E o p a
èopoe	è o p oe	E o p u
èoqoe	è o q oe	E o ' u
èoqoq	è o q o q	E o ' o '
èoqoqie	è o q o q ie	E o ' o ' i
èoraie	è o r a ie	E o r a i
èpa	è p a	E p a
èpa(ä)hona	è p a ( ä ) h o n a	E p a ( ' a ) h o n a
èpaäno	è p a ä n o	E p a ' a n o
èpaäo	è p a ä o	E p a ' a o
èpaboriekie	è p a b o r ie k ie	E p a b o r i k i
èpadoedoe	è p a d oe d oe	E p a d u d u
èpaèka	è p a è k a	E p a E k a
èpaèloèpaèloie	è p a è l oè p a è l o ie	E p a E l u p a E l o i
èpaènoqjaqä	è p a è n o q j a qä	E p a E n o ' j a ' a
èpaèpa	è p a è p a	E p a E p a
èpahiedoa	è p a h ie d o a	E p a h i d o a
èpahjoe	è p a h j oe	E p a h j u
èèdako	è è d a k o	E E d a k o
èpaho	è p a h o	E p a h o
èpahoäq	è p a h o ä q	E p a h o ' a '
èpahoe(w)a	è p a h oe ( w ) a	E p a h u ( w ) a
èpaienoä	è p a ie n o ä	E p a i n o ' a
èpaka	è p a k a	E p a k a
èpakamaie	è p a k a m a ie	E p a k a m a i
èpakèlie	è p a k è l ie	E p a k E l i
èpakoehè	è p a k oe h è	E p a k u h E
èpakoeie	è p a k oe ie	E p a k u i
èpako(w)a	è p a k o ( w ) a	E p a k o ( w ) a
èpalè	è p a l è	E p a l E
èpananaö	è p a n a n a ö	E p a n a n a ' o
èpanoe	è p a n oe	E p a n u
èpanoeka	è p a n oe k a	E p a n u k a
èpanèma	è p a n è m a	E p a n E m a
èpaö	è p a ö	E p a ' o
èpaopa	è p a o p a	E p a o p a
èpaoqöqaie	è p a o q ö q a ie	E p a o ' u̇ ' a i
èpè	è p è	E p E
èpèa	è p è a	E p E a
èpèa(ie)ha	è p è a ( ie ) h a	E p E a ( i ) h a
èpèdjie	è p è dj ie	E p E j i
èpèdjiekèèqbara	è p è dj ie k è è q b a r a	E p E j i k E E ' b a r a
èpèdo(w)a(ö)	è p è d o ( w ) a ( ö )	E p E d o ( w ) a ( ' o )
èpèhè	è p è h è	E p E h E
èpèkoe(w)aq	è p è k oe ( w ) a q	E p E k u ( w ) a '
èpèkoeqwaq	è p è k oe q w a q	E p E k u ' w a '
èpènaö	è p è n a ö	E p E n a ' o
èpèrhaoedie	è p è r h a oe d ie	E p E r h a u d i
èpèrie(j)oq	è p è r ie ( j ) o q	E p E r i ( j ) o '
èpieako(w)èq	è p ie a k o ( w ) è q	E p i a k o ( w ) E '
èpieaoe(w)apo	è p ie a oe ( w ) a p o	E p i a u ( w ) a p o
èpiedjaja	è p ie dj a j a	E p i j a j a
èpiedjoe	è p ie dj oe	E p i j u
èpiedjoeapo	è p ie dj oe a p o	E p i j u a p o
èpieho; èpiehooe(è)oe(w)è	è p ie h o ; # è p ie h o oe ( è ) oe ( w ) è	E p i h o ; # E p i h o u ( E ) u ( w ) E
èpie(j)a	è p ie ( j ) a	E p i ( j ) a
èpie(j)opie(j)o	è p ie ( j ) o p ie ( j ) o	E p i ( j ) o p i ( j ) o
èpieko	è p ie k o	E p i k o
èpienie	è p ie n ie	E p i n i
èpieniepie	è p ie n ie p ie	E p i n i p i
èpiepie	è p ie p ie	E p i p i
èpoäq	è p o ä q	E p o ' a '
èpoeäo	è p oe ä o	E p u ' a o
èpoedarie	è p oe d a r ie	E p u d a r i
èpoedoe	è p oe d oe	E p u d u
èpoeha	è p oe h a	E p u h a
èpoeiehoe	è p oe ie h oe	E p u i h u
èpoeko	è p oe k o	E p u k o
èpoenoe	è p oe n oe	E p u n u
èpoeoe	è p oeoe	E p u ' u
èpoe(oe)qoe	è p oe ( oe ) q oe	E p u ( u ) ' u
èpoe(oe)qoe: oe(w)apo	è p oe ( oe ) q oe : # oe ( w ) a p o	E p u ( u ) ' u : # u ( w ) a p o
oe(w)aie	oe ( w ) a ie	u ( w ) a i
èpoeroedoe(ie)	è p oe r oe d oe ( ie )	E p u r u d u ( i )
èpoeroedoe(ie): èoedoe	è p oe r oe d oe ( ie ) : # è oe d oe	E p u r u d u ( i ) : # E u d u
oebaka	oe b a k a	u b a k a
èpoeroedoe(ie)	è p oe r oe d oe ( ie )	E p u r u d u ( i )
èpoeroedoe(ie): aniemaie	è p oe r oe d oe ( ie ) : # a n ie m a ie	E p u r u d u ( i ) : # a n i m a i
èko(ö)qko(ö)q	è k o ( ö ) q k o ( ö ) q	E k o ( ' o ) ' k o ( ' o ) '
oeietjo	oe ie tj o	u i c o
èpo(ah)ha	è p o ( a h ) h a	E p o ( a h ) h a
èpoh	è p o h	E p o h
èpohkèaq	è p o h k è a q	E p o h k E a '
èpoko	è p o k o	E p o k o
èponanamè	è p o n a n a m è	E p o n a n a m E
èpo(ö)kaha	è p o ( ö ) k a h a	E p o ( ' o ) k a h a
èpoökie	è p o ö k ie	E p o ' o k i
èpoqa	è p o q a	E p o ' a
èpo(q)ienamo	è p o ( q ) ie n a m o	E p o ( ' ) i n a m o
èporo	è p o r o	E p o r o
(èq)èhoenè	( è q ) è h oe n è	( E ' ) E h u n E
ètèbè	è t è b è	E t E b E
èwakiepöro	è w a k ie p ö r o	E w a k i p u̇ r o
garam	g a r a m	g a r a m
goeroe	g oe r oe	g u r u
ha	h a	h a
habakao	h a b a k a o	h a b a k a o
haboejaq	h a b oe j a q	h a b u j a '
haie	h a ie	h a i
haiejaha	h a ie j a h a	h a i j a h a
abahaiejaha	a b a h a ie j a h a	a b a h a i j a h a
kahaiejaha	k a h a ie j a h a	k a h a i j a h a
halè	h a l è	h a l E
hamèhènie	h a m è h è n ie	h a m E h E n i
haoe	h a oe	h a u
hèdapiehie	h è d a p ie h ie	h E d a p i h i
hèie(j)o	h è ie ( j ) o	h E i ( j ) o
hie	h ie	h i
hiebaie	h ie b a ie	h i b a i
hieie(j)oie(j)o	h ie ie ( j ) o ie ( j ) o	h i i ( j ) o i ( j ) o
hie(j)onie	h ie ( j ) o n ie	h i ( j ) o n i
hienoea	h ie n oe a	h i n u a
ho	h o	h o
hoäkoqaq	h o ä k o q a q	h o ' a k o ' a '
hobaäoeie(j)aka	h o b a ä oe ie ( j ) a k a	h o b a ' a u i ( j ) a k a
hobaäoe(w)a	h o b a ä oe ( w ) a	h o b a ' a u ( w ) a
hobahaba	h o b a h a b a	h o b a h a b a
hobèèaö	h o b è è a ö	h o b E E a ' o
hoboek	h o b oe k	h o b u k
hödahöda	h ö d a h ö d a	h u̇ d a h u̇ d a
hodiedieka	h o d ie d ie k a	h o d i d i k a
hodiekie	h o d ie k ie	h o d i k i
hoèana	h oè a n a	h u a n a
hoeka	h oe k a	h u k a
hoeko(q)ä	h oe k o (q)ä	h u k o ( ' ) a
hoeoenoeka	h oeoe n oe k a	h u ' u n u k a
hoie	h o ie	h o i
höka	h ö k a	h u̇ k a
homaie	h o m a ie	h o m a i
homanieka	h o m a n ie k a	h o m a n i k a
hona(o)	h o n a ( o )	h o n a ( o )
honoaha	h o n o a h a	h o n o a h a
hopaie	h o p a ie	h o p a i
hopanao	h o p a n a o	h o p a n a o
ie	ie	i
iedjie	ie dj ie	i j i
ieho	ie h o	i h o
ieho akoloe poq	ie h o # a k o l oe # p o q	i h o # a k o l u # p o '
iehoie(j)ana	ie h o ie ( j ) a n a	i h o i ( j ) a n a
ie(j)aäo	ie ( j ) a ä o	i ( j ) a ' a o
ie(j)abie	ie ( j ) a b ie	i ( j ) a b i
ie(j)aha(ie)	ie ( j ) a h a ( ie )	i ( j ) a h a ( i )
ie(j)ahaoeoeaq	ie ( j ) a h a oeoe a q	i ( j ) a h a u ' u a '
ie(j)o	ie ( j ) o	i ( j ) o
ie(j)oho	ie ( j ) o h o	i ( j ) o h o
ie(j)okie	ie ( j ) o k ie	i ( j ) o k i
ie(j)omoö	ie ( j ) o m o ö	i ( j ) o m o ' o
ie(j)onie	ie ( j ) o n ie	i ( j ) o n i
ie(j)onie(j)a	ie ( j ) o n ie ( j ) a	i ( j ) o n i ( j ) a
ieka	ie k a	i k a
iekahaö	ie k a h a ö	i k a h a ' o
iekahoboe(w)ara	ie k a h o b oe ( w ) a r a	i k a h o b u ( w ) a r a
iekara	ie k a r a	i k a r a
iekoedoha	ie k oe d o h a	i k u d o h a
iekoeko	ie k oe k o	i k u k o
ienaou(w)a	ie n a o u ( w ) a	i n a o u ( w ) a
ienoenoeq	ie n oe n oe q	i n u n u '
ienoqie	ie n o q ie	i n o ' i
ietaqoe(w)a	ie t a q oe ( w ) a	i t a ' u ( w ) a
ietèq	ie t è q	i t E '
ietjo	ie tj o	i c o
ietjoehaq	ie tj oe h a q	i c u h a '
ka	k a	k a
kaä	k a ä	k a ' a
kaäämie	k a ä ä m ie	k a ' a ʔ a m i
kaä(ä)oe(w)a	k a ä ( ä ) oe ( w ) a	k a ' a ( ʔ a ) u ( w ) a
kaädahoaie	k a ä d a h o a ie	k a ' a d a h o a i
kaädodie	k a ä d o d ie	k a ' a d o d i
kaädo(j)a	k a ä d o ( j ) a	k a ' a d o ( j ) a
kaähoeöie	k a ä h oe ö ie	k a ' a h u ' o i
kaäjoq	k a ä j o q	k a ' a j o '
ka(ä)kèo	k a ( ä ) k è o	k a ( ' a ) k E o
kaäkèho	k a ä k è h o	k a ' a k E h o
kaäkie	k a ä k ie	k a ' a k i
kaäkieè	k a ä k ie è	k a ' a k i E
kaäkiekie(j)ĕ	k a ä k ie k ie ( j ) ĕ	k a ' a k i k i ( j ) ė
kaäkienafah	k a ä k ie n a f a h	k a ' a k i n a f a h
kaäkienè	k a ä k ie n è	k a ' a k i n E
kaäkieniepa	k a ä k ie n ie p a	k a ' a k i n i p a
kaäkoeka(h)	k a ä k oe k a ( h )	k a ' a k u k a ( h )
kaäkoho	k a ä k o h o	k a ' a k o h o
kaämie	k a ä m ie	k a ' a m i
kaäoe	k a ä oe	k a ' a u
kaäpaoe	k a ä p a oe	k a ' a p a u
kaäpèaäaq	k a ä p è a ä a q	k a ' a p E a ' a a '
kaäpoho	k a ä p o h o	k a ' a p o h o
kababahaq	k a b a b a h a q	k a b a b a h a '
kabáèlo	k a b á è l o	k a b a E l o
kabahoa	k a b a h o a	k a b a h o a
kabahöjaäq	k a b a h ö j a ä q	k a b a h u̇ j a ' a '
kabakoä	k a b a k o ä	k a b a k o ' a
kabatjoä	k a b a tj o ä	k a b a c o ' a
kabĕa	k a b ĕ a	k a b ė a
kabèhoq	k a b è h o q	k a b E h o '
kabiekaka	k a b ie k a k a	k a b i k a k a
kabiekèbie	k a b ie k è b ie	k a b i k E b i
kaboe(w)aboe(w)a	k a b oe ( w ) a b oe ( w ) a	k a b u ( w ) a b u ( w ) a
kaboekoe	k a b oe k oe	k a b u k u
kadèadèa	k a d è a d è a	k a d E a d E a
kadèda	k a d è d a	k a d E d a
kadèdè	k a d è d è	k a d E d E
kadiehie	k a d ie h ie	k a d i h i
kadiekopo	k a d ie k o p o	k a d i k o p o
kadoboedoboe	k a d o b oe d o b oe	k a d o b u d o b u
kadodohodie	k a d o d o h o d ie	k a d o d o h o d i
kadoèhoeda	k a d oè h oe d a	k a d u h u d a
kadoqö	k a d o q ö	k a d o ' u̇
kaènaha	k a è n a h a	k a E n a h a
kaènoe	k a è n oe	k a E n u
kaèöèo	k a è ö è o	k a E u̇ E o
kah	k a h	k a h
kaha	k a h a	k a h a
kahabaja	k a h a b a j a	k a h a b a j a
kahabaoeba	k a h a b a oe b a	k a h a b a u b a
kahabarieq	k a h a b a r ie q	k a h a b a r i '
kahabieta	k a h a b ie t a	k a h a b i t a
kahaè	k a h a è	k a h a E
kahapa	k a h a p a	k a h a p a
kahaho	k a h a h o	k a h a h o
kahaie	k a h a ie	k a h a i
kahaiekoenaq	k a h a ie k oe n a q	k a h a i k u n a '
kahaienoeapè	k a h a ie n oe a p è	k a h a i n u a p E
kahaja	k a h a j a	k a h a j a
kahakakie	k a h a k a k ie	k a h a k a k i
kahakouda	k a h a k o u d a	k a h a k o u d a
kahao	k a h a o	k a h a o
kahao: èmanie	k a h a o : # è m a n ie	k a h a o : # E m a n i
èhöda	è h ö d a	E h u̇ d a
kahaoeq	k a h a oe q	k a h a u '
kahaoka	k a h a o k a	k a h a o k a
kahapaq	k a h a p a q	k a h a p a '
kahapie	k a h a p ie	k a h a p i
kahapoeoeie(j)a	k a h a p oeoe ie ( j ) a	k a h a p u ' u i ( j ) a
kahapoeqoeie	k a h a p oe q oe ie	k a h a p u ' u i
kaharao	k a h a r a o	k a h a r a o
kahèdohèdo	k a h è d o h è d o	k a h E d o h E d o
kahèè	k a h è è	k a h E E
kahè(j)oq	k a h è ( j ) o q	k a h E ( j ) o '
kahiekanie	k a h ie k a n ie	k a h i k a n i
kahienoaq	k a h ie n o a q	k a h i n o a '
kahiepa	k a h ie p a	k a h i p a
kahoeie(j)oeroe(w)a	k a h oe ie ( j ) oe r oe ( w ) a	k a h u i ( j ) u r u ( w ) a
kahoepohoepoö	k a h oe p o h oe p o ö	k a h u p o h u p o ' o
kahopo	k a h o p o	k a h o p o
kahö(w)a	k a h ö ( w ) a	k a h u̇ ( w ) a
kaie	k a ie	k a i
kaie(j)aè	k a ie ( j ) a è	k a i ( j ) a E
kaie(j)anono	k a ie ( j ) a n o n o	k a i ( j ) a n o n o
kaie(j)ojo(q)	k a ie ( j ) o j o ( q )	k a i ( j ) o j o ( ' )
kaiekoko	k a ie k o k o	k a i k o k o
kaienono(q)	k a ie n o n o ( q )	k a i n o n o ( ' )
kajajaä	k a j a j a ä	k a j a j a ' a
kajo	k a j o	k a j o
kajoöie	k a j o ö ie	k a j o ' o i
kakanaka	k a k a n a k a	k a k a n a k a
kakanakoe(w)a	k a k a n a k oe ( w ) a	k a k a n a k u ( w ) a
kakanèha	k a k a n è h a	k a k a n E h a
kakaraie	k a k a r a ie	k a k a r a i
kakarie(j)o	k a k a r ie ( j ) o	k a k a r i ( j ) o
kakèkaka	k a k è k a k a	k a k E k a k a
kakèlèha	k a k è l è h a	k a k E l E h a
kakiedahaie(j)o	k a k ie d a h a ie ( j ) o	k a k i d a h a i ( j ) o
kakiedjoa	k a k ie dj o a	k a k i j o a
kakiedohè	k a k ie d o h è	k a k i d o h E
kakiekiedohè	k a k ie k ie d o h è	k a k i k i d o h E
kakiekie(j)oe	k a k ie k ie ( j ) oe	k a k i k i ( j ) u
kakiepakiepa	k a k ie p a k ie p a	k a k i p a k i p a
kakoehè	k a k oe h è	k a k u h E
kakoenjè	k a k oe nj è	k a k u ñ E
kakoeöqö	k a k oe ö q ö	k a k u ' o ' u̇
kaköoe	k a k ö oe	k a k u̇ u
kakoro(w)a	k a k o r o ( w ) a	k a k o r o ( w ) a
kalèaq	k a l è a q	k a l E a '
kalèaq(oe)baba	k a l è a q ( oe ) b a b a	k a l E a ' ( u ) b a b a
kamanaä	k a m a n a ä	k a m a n a ' a
kamoepie	k a m oe p ie	k a m u p i
kamoenieno	k a m oe n ie n o	k a m u n i n o
kamoho	k a m o h o	k a m o h o
kamonie	k a m o n ie	k a m o n i
kanakienie	k a n a k ie n ie	k a n a k i n i
kanapoe	k a n a p oe	k a n a p u
kanapoeäq	k a n a p oe ä q	k a n a p u ' a '
kanapoenoe	k a n a p oe n oe	k a n a p u n u
kanèko	k a n è k o	k a n E k o
kanènè	k a n è n è	k a n E n E
kanènonèno	k a n è n o n è n o	k a n E n o n E n o
kanèonèo	k a n è o n è o	k a n E o n E o
kanèpoe	k a n è p oe	k a n E p u
kanè(q)a	k a n è ( q ) a	k a n E ( ' ) a
kaniehie	k a n ie h ie	k a n i h i
kaniekie	k a n ie k ie	k a n i k i
kaniekoä(a)q	k a n ie k o ä ( a ) q	k a n i k o ' a ( a ) '
kanie(nie)kie	k a n ie ( n ie ) k ie	k a n i ( n i ) k i
kanieniepo(w)a	k a n ie n ie p o ( w ) a	k a n i n i p o ( w ) a
kanoeaie	k a n oe a ie	k a n u a i
kanoeanoea	k a n oe a n oe a	k a n u a n u a
kanoeqkoe(w)aie	k a n oe q k oe ( w ) a ie	k a n u ' k u ( w ) a i
kanoöho(w)aq	k a n o ö h o ( w ) a q	k a n o ' o h o ( w ) a '
kao(e)	k a o ( e )	k a o ( e )
kaoeäq	k a oe ä q	k a u ' a '
kaoedada	k a oe d a d a	k a u d a d a
kaoedahjo	k a oe d a h j o	k a u d a h j o
kaoedaoe(w)arah	k a oe d a oe ( w ) a r a h	k a u d a u ( w ) a r a h
kaoedèqää	k a oe d è q ää	k a u d E ' a ' a
kaoenie(j)a	k a oe n ie ( j ) a	k a u n i ( j ) a
kaoepè(q)	k a oe p è ( q )	k a u p E ( ' )
kaoe(w)a	k a oe ( w ) a	k a u ( w ) a
kaoe(w)èoe(w)è	k a oe ( w ) è oe ( w ) è	k a u ( w ) E u ( w ) E
kaoe(w)ie	k a oe ( w ) ie	k a u ( w ) i
kaokie	k a o k ie	k a o k i
kaoöbo	k a o ö b o	k a o ' o b o
kaoöèiedjie	k a o ö è ie dj ie	k a o ' o E i j i
kaoöo	k a o ö o	k a o ' o o
kapaie	k a p a ie	k a p a i
kapal	k a p a l	k a p a l
kapal api	k a p a l # a p i	k a p a l # a p i
kapaoe	k a p a oe	k a p a u
kapĕrapĕraba	k a p ĕ r a p ĕ r a b a	k a p ė r a p ė r a b a
kapieho	k a p ie h o	k a p i h o
kapoe	k a p oe	k a p u
kapoeho	k a p oe h o	k a p u h o
kapoeka	k a p oe k a	k a p u k a
kapoeq(oe)a	k a p oe q ( oe ) a	k a p u ' ( u ) a
kapoko	k a p o k o	k a p o k o
kapopo	k a p o p o	k a p o p o
kĕpopo	k ĕ p o p o	k ė p o p o
kaqakaie	k a q a k a ie	k a ' a k a i
kaqamano	k a q a m a n o	k a ' a m a n o
kaqapopoero	k a q a p o p oe r o	k a ' a p o p u r o
kaqienèaoe	k a q ie n è a oe	k a ' i n E a u
karaoe	k a r a oe	k a r a u
karieporiepo	k a r ie p o r ie p o	k a r i p o r i p o
karoe(oe)(w)a	k a r oe ( oe ) ( w ) a	k a r u ( u ) ( w ) a
karohaja	k a r o h a j a	k a r o h a j a
karorie(j)ĕ	k a r o r ie ( j ) ĕ	k a r o r i ( j ) ė
kĕbahè	k ĕ b a h è	k ė b a h E
kĕlamboe	k ĕ l a m b oe	k ė l a m b u
kĕmie(j)oe	k ĕ m ie ( j ) oe	k ė m i ( j ) u
kĕnaja	k ĕ n a j a	k ė n a j a
kĕwalie	k ĕ w a l ie	k ė w a l i
kè	k è	k E
kèè	k è è	k E E
kèhèkoq	k è h è k o q	k E h E k o '
kèhèla	k è h è l a	k E h E l a
kèho	k è h o	k E h o
kèhodojo	k è h o d o j o	k E h o d o j o
kèhowa	k è h o w a	k E h o w a
kèkèqie	k è k è q ie	k E k E ' i
kèkoe(w)èq	k è k oe ( w ) è q	k E k u ( w ) E '
kèlokèlo	k è l o k è l o	k E l o k E l o
kèma	k è m a	k E m a
kèmonaq	k è m o n a q	k E m o n a '
kèo	k è o	k E o
kie	k ie	k i
kiea	k ie a	k i a
kieadoboe	k ie a d o b oe	k i a d o b u
kieakie	k ie a k ie	k i a k i
kieakoena	k ie a k oe n a	k i a k u n a
kieakoeq	k ie a k oe q	k i a k u '
kieapaä	k ie a p a ä	k i a p a ' a
kiebaka	k ie b a k a	k i b a k a
kiebèdieka	k ie b è d ie k a	k i b E d i k a
kieboeho	k ie b oe h o	k i b u h o
kiebohèie	k ie b o h è ie	k i b o h E i
kiedahoho	k ie d a h o h o	k i d a h o h o
kiedahaq	k ie d a h a q	k i d a h a '
kiedahoaq	k ie d a h o a q	k i d a h o a '
kiedajaq	k ie d a j a q	k i d a j a '
kiedaoedaoe	k ie d a oe d a oe	k i d a u d a u
kiedara	k ie d a r a	k i d a r a
kiedèdè(j)aq	k ie d è d è ( j ) a q	k i d E d E ( j ) a '
kiedie	k ie d ie	k i d i
kiedie (è)kèho	k ie d ie # ( è ) k è h o	k i d i # ( E ) k E h o
kiediediehoq	k ie d ie d ie h o q	k i d i d i h o '
kiediedieka	k ie d ie d ie k a	k i d i d i k a
kiedieopè	k ie d ie o p è	k i d i o p E
kiediepoe	k ie d ie p oe	k i d i p u
kiediepoe (èq)èhoenè	k ie d ie p oe # ( è q ) è h oe n è	k i d i p u # ( E ' ) E h u n E
kiedjaieie(j)aq	k ie dj a ie ie ( j ) a q	k i j a i i ( j ) a '
kiedjie	k ie dj ie	k i j i
kiedjiedjieö	k ie dj ie dj ie ö	k i j i j i ' o
kiedjiekiedjie	k ie dj ie k ie dj ie	k i j i k i j i
kiedjoro	k ie dj o r o	k i j o r o
kiedo	k ie d o	k i d o
kiedobieka	k ie d o b ie k a	k i d o b i k a
kiedodo	k ie d o d o	k i d o d o
kiedodo iedjie	k ie d o d o # ie dj ie	k i d o d o # i j i
kiedoropoq	k ie d o r o p o q	k i d o r o p o '
kieè(ja)	k ie è ( j a )	k i E ( j a )
kièèlo	k iè è l o	k i E l o
kieènoe	k ie è n oe	k i E n u
kiehiebie(j)a	k ie h ie b ie ( j ) a	k i h i b i ( j ) a
kiehiema(na)	k ie h ie m a ( n a )	k i h i m a ( n a )
kiehiema(na)èodie	k ie h ie m a ( n a ) è o d ie	k i h i m a ( n a ) E o d i
kiehieoba	k ie h ie o b a	k i h i o b a
kiehoè(j)a	k ie h oè ( j ) a	k i h u ( j ) a
kiehohoda(q)	k ie h o h o d a ( q )	k i h o h o d a ( ' )
kieiedoka	k ie ie d o k a	k i i d o k a
kieie(j)oèdaha	k ie ie ( j ) oè d a h a	k i i ( j ) u d a h a
kieiepo	k ie ie p o	k i i p o
kieietjo	k ie ie tj o	k i i c o
kie(j)a	k ie ( j ) a	k i ( j ) a
kie(j)abaq	k ie ( j ) a b a q	k i ( j ) a b a '
kie(j)abaq iekèo	k ie ( j ) a b a q # ie k è o	k i ( j ) a b a ' # i k E o
kie(j)ahariedjoe	k ie ( j ) a h a r ie dj oe	k i ( j ) a h a r i j u
kie(j)aie	k ie ( j ) a ie	k i ( j ) a i
kie(j)oenano	k ie ( j ) oe n a n o	k i ( j ) u n a n o
kie(j)oèdoha	k ie ( j ) oè d o h a	k i ( j ) u d o h a
kie(j)oha	k ie ( j ) o h a	k i ( j ) o h a
kie(j)oho	k ie ( j ) o h o	k i ( j ) o h o
kie(j)okko	k ie ( j ) o k k o	k i ( j ) o k k o
kie(j)opèka	k ie ( j ) o p è k a	k i ( j ) o p E k a
kie(j)oqoqaq	k ie ( j ) o q o q a q	k i ( j ) o ' o ' a '
kiekaäboe	k ie k a ä b oe	k i k a ' a b u
kiekaäna	k ie k a ä n a	k i k a ' a n a
kiekabiedja	k ie k a b ie dj a	k i k a b i j a
kiekahaoeba	k ie k a h a oe b a	k i k a h a u b a
kiekaoba	k ie k a o b a	k i k a o b a
kiekaraq(a)	k ie k a r a q ( a )	k i k a r a ' ( a )
kiekĕnènaq	k ie k ĕ n è n a q	k i k ė n E n a '
kiekĕroa	k ie k ĕ r o a	k i k ė r o a
kiekèèla	k ie k è è l a	k i k E E l a
kiekè(è)oe(w)a	k ie k è ( è ) oe ( w ) a	k i k E ( E ) u ( w ) a
kiekèora(q)	k ie k è o r a ( q )	k i k E o r a ( ' )
kiekèpoqä	k ie k è p o qä	k i k E p o ' a
kiekèpoqoe(w)a	k ie k è p o q oe ( w ) a	k i k E p o ' u ( w ) a
kiekèqie	k ie k è q ie	k i k E ' i
kiekie(j)a	k ie k ie ( j ) a	k i k i ( j ) a
kiekie(j)aqkie(j)aq	k ie k ie ( j ) a q k ie ( j ) a q	k i k i ( j ) a ' k i ( j ) a '
kiekie(j)ara	k ie k ie ( j ) a r a	k i k i ( j ) a r a
kiekie(j)o	k ie k ie ( j ) o	k i k i ( j ) o
kiekienie	k ie k ie n ie	k i k i n i
kiekoekoe(q)ö	k ie k oe k oe ( q ) ö	k i k u k u ( ' ) u̇
kiekoho	k ie k o h o	k i k o h o
kiekohodaq	k ie k o h o d a q	k i k o h o d a '
kiekoko	k ie k o k o	k i k o k o
kiekokonie(j)a	k ie k o k o n ie ( j ) a	k i k o k o n i ( j ) a
kiekononaq	k ie k o n o n a q	k i k o n o n a '
kiekooe(w)a	k ie k o oe ( w ) a	k i k o u ( w ) a
kiekoöka	k ie k o ö k a	k i k o ' o k a
kiekoro(w)a	k ie k o r o ( w ) a	k i k o r o ( w ) a
kielaoeloe	k ie l a oe l oe	k i l a u l u
kiemèmè èbahaoeq	k ie m è m è # è b a h a oe q	k i m E m E # E b a h a u '
kiemoenie	k ie m oe n ie	k i m u n i
kiemoenie(j)o	k ie m oe n ie ( j ) o	k i m u n i ( j ) o
kiemomojo	k ie m o m o j o	k i m o m o j o
kienanaja	k ie n a n a j a	k i n a n a j a
kienanapa	k ie n a n a p a	k i n a n a p a
kienienaqèkaq	k ie n ie n a q è k a q	k i n i n a ' E k a '
kienienèqa	k ie n ie n è q a	k i n i n E ' a
kienjono	k ie nj o n o	k i ñ o n o
kieno	k ie n o	k i n o
kienoäo	k ie n o ä o	k i n o ' a o
kienoeoeka	k ie n oeoe k a	k i n u ' u k a
kienono	k ie n o n o	k i n o n o
kienono: è(j)a	k ie n o n o : # è ( j ) a	k i n o n o : # E ( j ) a
è(j)adie(j)a	è ( j ) a d ie ( j ) a	E ( j ) a d i ( j ) a
è(j)aè	è ( j ) a è	E ( j ) a E
kienoöna(w)aie	k ie n o ö n a ( w ) a ie	k i n o ' o n a ( w ) a i
kienoqè(j)a	k ie n o q è ( j ) a	k i n o ' E ( j ) a
kiodèa	k i o d è a	k i o d E a
kieoenèkaq	k ie oe n è k a q	k i u n E k a '
kieojo	k ie o j o	k i o j o
kieokahaie	k ie o k a h a ie	k i o k a h a i
kieonieka	k ie o n ie k a	k i o n i k a
kieoö	k ie o ö	k i o ' o
kieoöäaq	k ie o ö ä a q	k i o ' o ʔ a a '
kieoöie	k ie o ö ie	k i o ' o i
kieoöno	k ie o ö n o	k i o ' o n o
kieoönopa	k ie o ö n o p a	k i o ' o n o p a
kiepa(a)oeq	k ie p a ( a ) oe q	k i p a ( a ) u '
kiepadie; kiepadieoeiedjie	k ie p a d ie ; # k ie p a d ie oe ie dj ie	k i p a d i ; # k i p a d i u i j i
kiepahoe(w)a	k ie p a h oe ( w ) a	k i p a h u ( w ) a
kiepaka	k ie p a k a	k i p a k a
kiepakaowaq	k ie p a k a o w a q	k i p a k a o w a '
kiepakiedja	k ie p a k ie dj a	k i p a k i j a
kiepa; kiepakiepa pahoeoenaq	k ie p a ; # k ie p a k ie p a # p a h oeoe n a q	k i p a ; # k i p a k i p a # p a h u ' u n a '
kiepakobaq	k ie p a k o b a q	k i p a k o b a '
kiepakoeka	k ie p a k oe k a	k i p a k u k a
kiepakoekoeoedie	k ie p a k oe k oeoe d ie	k i p a k u k u ' u d i
kiepakoko	k ie p a k o k o	k i p a k o k o
kiepakokokie	k ie p a k o k o k ie	k i p a k o k o k i
kiepamiemiehieka	k ie p a m ie m ie h ie k a	k i p a m i m i h i k a
kiepamo	k ie p a m o	k i p a m o
kiepamoemoeoeie	k ie p a m oe m oeoe ie	k i p a m u m u ' u i
kiepapakoe	k ie p a p a k oe	k i p a p a k u
kiepaqaq	k ie p a q a q	k i p a ' a '
kieparaèbahao(q)	k ie p a r a è b a h a o ( q )	k i p a r a E b a h a o ( ' )
kieparahpie	k ie p a r a h p ie	k i p a r a h p i
kieparahopie	k ie p a r a h o p ie	k i p a r a h o p i
kieparoa	k ie p a r o a	k i p a r o a
kiepĕraiedie(j)og	k ie p ĕ r a ie d ie ( j ) o g	k i p ė r a i d i ( j ) o g
kiepĕhaie	k ie p ĕ h a ie	k i p ė h a i
kiepèhèboeöbo	k ie p è h è b oe ö b o	k i p E h E b u ' o b o
kiepèhodo	k ie p è h o d o	k i p E h o d o
kiepèoraq	k ie p è o r a q	k i p E o r a '
kiepiepie	k ie p ie p ie	k i p i p i
kiepoäka	k ie p o ä k a	k i p o ' a k a
kiepoäraq	k ie p o ä r a q	k i p o ' a r a '
kiepoedieka	k ie p oe d ie k a	k i p u d i k a
kiepoefoe	k ie p oe f oe	k i p u f u
kiepoeoeda	k ie p oeoe d a	k i p u ' u d a
kiepoe(w)a	k ie p oe ( w ) a	k i p u ( w ) a
kiepohajĕ	k ie p o h a j ĕ	k i p o h a j ė
kiepokana	k ie p o k a n a	k i p o k a n a
kiepokiepo	k ie p o k ie p o	k i p o k i p o
kiepoö	k ie p o ö	k i p o ' o
kiepopoä	k ie p o p o ä	k i p o p o ' a
kiepoqöaq	k ie p o q ö a q	k i p o ' u̇ a '
kieqja	k ie q j a	k i ' j a
koahajo	k o a h a j o	k o a h a j o
koahie(j)a	k o a h ie ( j ) a	k o a h i ( j ) a
koahie(j)a kapoe	k o a h ie ( j ) a # k a p oe	k o a h i ( j ) a # k a p u
köda	k ö d a	k u̇ d a
kodo	k o d o	k o d o
koe	k oe	k u
koeano	k oe a n o	k u a n o
koedaqä	k oe d a qä	k u d a ' a
koedè	k oe d è	k u d E
koedè: iejaha	k oe d è : # ie j a h a	k u d E : # i j a h a
iepoko	ie p o k o	i p o k o
ietopo	ie t o p o	i t o p o
koedèja	k oe d è j a	k u d E j a
koedodoka	k oe d o d o k a	k u d o d o k a
koedoe	k oe d oe	k u d u
koehaie	k oe h a ie	k u h a i
koehèdie	k oe h è d ie	k u h E d i
koehèdie(j)aq	k oe h è d ie ( j ) a q	k u h E d i ( j ) a '
koehiemaq	k oe h ie m a q	k u h i m a '
koeie; koeie karieha	k oe ie ; # k oe ie # k a r ie h a	k u i ; # k u i # k a r i h a
koeiehie	k oe ie h ie	k u i h i
koeienaq	k oe ie n a q	k u i n a '
koejaq	k oe j a q	k u j a '
koekaq	k oe k a q	k u k a '
koekoebaka	k oe k oe b a k a	k u k u b a k a
koemènoeè	k oe m è n oe è	k u m E n u E
koemoe	k oe m oe	k u m u
koenajo	k oe n a j o	k u n a j o
koepèie	k oe p è ie	k u p E i
koeripo	k oe r i p o	k u r i p o
koe(w)a	k oe ( w ) a	k u ( w ) a
koe(w)adie	k oe ( w ) a d ie	k u ( w ) a d i
kohèaq	k o h è a q	k o h E a '
kohopaie	k o h o p a ie	k o h o p a i
kohopie(j)oe	k o h o p ie ( j ) oe	k o h o p i ( j ) u
kokieha	k o k ie h a	k o k i h a
kokoäaq	k o k o ä a q	k o k o ' a a '
kokoĕ	k o k o ĕ	k o k o ė
kokoie(j)aèa	k o k o ie ( j ) a è a	k o k o i ( j ) a E a
kokona	k o k o n a	k o k o n a
(ko)koro(w)a	( k o ) k o r o ( w ) a	( k o ) k o r o ( w ) a
kolè	k o l è	k o l E
komojaqä	k o m o j a qä	k o m o j a ' a
komokomo	k o m o k o m o	k o m o k o m o
konèka	k o n è k a	k o n E k a
konohaq(?)	k o n o h a q ( ? )	k o n o h a ' ( ? )
kononaq	k o n o n a q	k o n o n a '
koöma	k o ö m a	k o ' o m a
kopènè	k o p è n è	k o p E n E
kopèq	k o p è q	k o p E '
kopo	k o p o	k o p o
kopodieqie	k o p o d ie q ie	k o p o d i ' i
koqoq	k o q o q	k o ' o '
koqoqma	k o q o q m a	k o ' o ' m a
koqowie	k o q o w ie	k o ' o w i
koraq	k o r a q	k o r a '
ma(ä)hona	m a ( ä ) h o n a	m a ( ' a ) h o n a
mahamè	m a h a m è	m a h a m E
mahona(q)	m a h o n a ( q )	m a h o n a ( ' )
maonè	m a o n è	m a o n E
mĕnokie	m ĕ n o k ie	m ė n o k i
miemie	m ie m ie	m i m i
miemiena	m ie m ie n a	m i m i n a
miena; mienaoe(w)apo	m ie n a ; # m ie n a oe ( w ) a p o	m i n a ; # m i n a u ( w ) a p o
mienaoe(w)aie	m ie n a oe ( w ) a ie	m i n a u ( w ) a i
mienjaq	m ie nj a q	m i ñ a '
moe	m oe	m u
mohoie	m o h o ie	m o h o i
mohomohoiena	m o h o m o h o ie n a	m o h o m o h o i n a
mokie	m o k ie	m o k i
moko	m o k o	m o k o
moko èodie die(j)a	m o k o # è o d ie # d ie ( j ) a	m o k o # E o d i # d i ( j ) a
moö	m o ö	m o ' o
naäie(j)aha	n a ä ie ( j ) a h a	n a ' a i ( j ) a h a
naäpoe(w)aka(q)	n a ä p oe ( w ) a k a ( q )	n a ' a p u ( w ) a k a ( ' )
naèhapè	n a è h a p è	n a E h a p E
nahaja	n a h a j a	n a h a j a
naienaie	n a ie n a ie	n a i n a i
naoemana	n a oe m a n a	n a u m a n a
naponaq	n a p o n a q	n a p o n a '
naqä	n a qä	n a ' a
naqie(j)aie	n a q ie ( j ) a ie	n a ' i ( j ) a i
nèènie	n è è n ie	n E E n i
nènèka	n è n è k a	n E n E k a
nie(j)a	n ie ( j ) a	n i ( j ) a
nie(j)oöhieniea	n ie ( j ) o ö h ie n ie a	n i ( j ) o ' o h i n i a
noaha; kienoaha	n o a h a ; # k ie n o a h a	n o a h a ; # k i n o a h a
noahaq	n o a h a q	n o a h a '
noèaäq	n oè a ä q	n u a ' a '
noenohoie	n oe n o h o ie	n u n o h o i
noha	n o h a	n o h a
nokie	n o k ie	n o k i
noöienĕ	n o ö ie n ĕ	n o ' o i n ė
noönie	n o ö n ie	n o ' o n i
no(q)o(q)ie	n o ( q ) o ( q ) ie	n o ( ' ) o ( ' ) i
oanoaha	o a n o a h a	o a n o a h a
obieoe(w)oeha	o b ie oe ( w ) oe h a	o b i u ( w ) u h a
ödaq	ö d a q	u̇ d a '
odokie	o d o k ie	o d o k i
oe	oe	u
oedaq	oe d a q	u d a '
oekèèpa	oe k è è p a	u k E E p a
oekiedopè	oe k ie d o p è	u k i d o p E
oemahaie	oe m a h a ie	u m a h a i
oemahaoe	oe m a h a oe	u m a h a u
oenèqie	oe n è q ie	u n E ' i
oeniekaq	oe n ie k a q	u n i k a '
oeöbie	oe ö b ie	u ' o b i
oeoe	oeoe	u ' u
oepanie	oe p a n ie	u p a n i
oepè	oe p è	u p E
oepĕhöjaäq	oe p ĕ h ö j a ä q	u p ė h u̇ j a ' a '
oepoena(ie)	oe p oe n a ( ie )	u p u n a ( i )
oe(w)a	oe ( w ) a	u ( w ) a
oe(w)aha	oe ( w ) a h a	u ( w ) a h a
oewĕoewĕ	oe w ĕ oe w ĕ	u w ė u w ė
okaie	o k a ie	o k a i
okie	o k ie	o k i
omiekoaqaha	o m ie k o a q a h a	o m i k o a ' a h a
omö	o m ö	o m u̇
öö	ö ö	u̇ u̇
oödokie	o ö d o k ie	o ' o d o k i
oökie(?)	o ö k ie ( ? )	o ' o k i ( ? )
opahie(j)aka	o p a h ie ( j ) a k a	o p a h i ( j ) a k a
opèkaäq	o p è k a ä q	o p E k a ' a '
opo	o p o	o p o
owahie	o w a h ie	o w a h i
paämahaie	p a ä m a h a ie	p a ' a m a h a i
pabèoe	p a b è oe	p a b E u
paboedajaq	p a b oe d a j a q	p a b u d a j a '
paböha	p a b ö h a	p a b u̇ h a
padahèboe(w)a	p a d a h è b oe ( w ) a	p a d a h E b u ( w ) a
padaiejaäq	p a d a ie j a ä q	p a d a i j a ' a '
padiehoie(j)aqä	p a d ie h o ie ( j ) a qä	p a d i h o i ( j ) a ' a
padiehopie	p a d ie h o p ie	p a d i h o p i
padiekaä	p a d ie k a ä	p a d i k a ' a
padoedoie	p a d oe d o ie	p a d u d o i
padoewaä	p a d oe w a ä	p a d u w a ' a
paèdoha	p a è d o h a	p a E d o h a
paèhie	p a è h ie	p a E h i
paèho	p a è h o	p a E h o
paèie	p a è ie	p a E i
paènoe	p a è n oe	p a E n u
pahabieaäq	p a h a b ie a ä q	p a h a b i a ' a '
pahaboe(w)ĕ	p a h a b oe ( w ) ĕ	p a h a b u ( w ) ė
pa(ha)böhaq	p a ( h a ) b ö h a q	p a ( h a ) b u̇ h a '
pahadodie(j)aäq	p a h a d o d ie ( j ) a ä q	p a h a d o d i ( j ) a ' a '
pahadoho; pahadoho èkiedjaie(j)oe	p a h a d o h o ; # p a h a d o h o # è k ie dj a ie ( j ) oe	p a h a d o h o ; # p a h a d o h o # E k i j a i ( j ) u
pahaèkoe	p a h a è k oe	p a h a E k u
pahakè(j)aq	p a h a k è ( j ) a q	p a h a k E ( j ) a '
pahakie(j)a	p a h a k ie ( j ) a	p a h a k i ( j ) a
pahakoienanaq	p a h a k o ie n a n a q	p a h a k o i n a n a '
pahaö	p a h a ö	p a h a ' o
pahapèaq	p a h a p è a q	p a h a p E a '
pahapoeè(q)	p a h a p oe è ( q )	p a h a p u E ( ' )
pahjo	p a h j o	p a h j o
pahodaie	p a h o d a ie	p a h o d a i
pahoehoedoe	p a h oe h oe d oe	p a h u h u d u
pahoemana	p a h oe m a n a	p a h u m a n a
pahoeoenaq	p a h oeoe n a q	p a h u ' u n a '
pahoqoekie	p a h o q oe k ie	p a h o ' u k i
pahoraie	p a h o r a ie	p a h o r a i
paienènèaq	p a ie n è n è a q	p a i n E n E a '
pakahadè	p a k a h a d è	p a k a h a d E
pakahopa	p a k a h o p a	p a k a h o p a
pakaö(w)aq	p a k a ö ( w ) a q	p a k a ' o ( w ) a '
pakarahaq	p a k a r a h a q	p a k a r a h a '
pakèho(w)oq	p a k è h o ( w ) o q	p a k E h o ( w ) o '
pakè(j)aq	p a k è ( j ) a q	p a k E ( j ) a '
pakèlie(j)a	p a k è l ie ( j ) a	p a k E l i ( j ) a
pakie(j)oe	p a k ie ( j ) oe	p a k i ( j ) u
pakiemaha	p a k ie m a h a	p a k i m a h a
pakieno	p a k ie n o	p a k i n o
pakieopo	p a k ie o p o	p a k i o p o
pakoba	p a k o b a	p a k o b a
pakoehè	p a k oe h è	p a k u h E
pakoehie(j)aq	p a k oe h ie ( j ) a q	p a k u h i ( j ) a '
pakoehö(j)aq	p a k oe h ö ( j ) a q	p a k u h u̇ ( j ) a '
pakoeienanaq	p a k oe ie n a n a q	p a k u i n a n a '
pakoenaq	p a k oe n a q	p a k u n a '
kèo pakoenaq aiekiedjaieboe	k è o # p a k oe n a q # a ie k ie dj a ie b oe	k E o # p a k u n a ' # a i k i j a i b u
pakoenoejo	p a k oe n oe j o	p a k u n u j o
pakoeoe(w)aq	p a k oeoe ( w ) a q	p a k u ' u ( w ) a '
pakoepèq	p a k oe p è q	p a k u p E '
pakoe(w)aq	p a k oe ( w ) a q	p a k u ( w ) a '
pakohaq	p a k o h a q	p a k o h a '
pako(q)öhaäq	p a k o ( q ) ö h a ä q	p a k o ( ' ) u̇ h a ' a '
pako(w)èhko(w)èh	p a k o ( w ) è h k o ( w ) è h	p a k o ( w ) E h k o ( w ) E h
pamahaoema	p a m a h a oe m a	p a m a h a u m a
pamahona	p a m a h o n a	p a m a h o n a
pamèmèho	p a m è m è h o	p a m E m E h o
pana(h)	p a n a ( h )	p a n a ( h )
panako	p a n a k o	p a n a k o
panakona	p a n a k o n a	p a n a k o n a
kie(j)abaq panakona	k ie ( j ) a b a q # p a n a k o n a	k i ( j ) a b a ' # p a n a k o n a
panakonaäq	p a n a k o n a ä q	p a n a k o n a ' a '
panaoe	p a n a oe	p a n a u
panapa	p a n a p a	p a n a p a
panè	p a n è	p a n E
hopanè	h o p a n è	h o p a n E
panènèhaie	p a n è n è h a ie	p a n E n E h a i
panieha(q)	p a n ie h a ( q )	p a n i h a ( ' )
paodèaq	p a o d è a q	p a o d E a '
paoeho(q)	p a oe h o ( q )	p a u h o ( ' )
paoe(w)a	p a oe ( w ) a	p a u ( w ) a
paoe(w)aoe	p a oe ( w ) a oe	p a u ( w ) a u
paopajaäq	p a o p a j a ä q	p a o p a j a ' a '
paopèkie(j)aq	p a o p è k ie ( j ) a q	p a o p E k i ( j ) a '
papa	p a p a	p a p a
papĕrabie	p a p ĕ r a b ie	p a p ė r a b i
papèa	p a p è a	p a p E a
papèhodie	p a p è h o d ie	p a p E h o d i
papoedoe	p a p oe d oe	p a p u d u
paqjo	p a q j o	p a ' j o
parabie	p a r a b ie	p a r a b i
parahoeie	p a r a h oe ie	p a r a h u i
parako(w)a	p a r a k o ( w ) a	p a r a k o ( w ) a
pariehoie(j)aqä	p a r ie h o ie ( j ) a qä	p a r i h o i ( j ) a ' a
pariepoepoeh	p a r ie p oe p oe h	p a r i p u p u h
parieqö	p a r ie q ö	p a r i ' u̇
paroepèie	p a r oe p è ie	p a r u p E i
paroähaja	p a r o ä h a j a	p a r o ' a h a j a
parobiekie	p a r o b ie k ie	p a r o b i k i
paroriepo	p a r o r ie p o	p a r o r i p o
pè	p è	p E
haboepè	h a b oe p è	h a b u p E
pè(j)aha	p è ( j ) a h a	p E ( j ) a h a
pĕkaka	p ĕ k a k a	p ė k a k a
pĕkakarie(j)aq	p ĕ k a k a r ie ( j ) a q	p ė k a k a r i ( j ) a '
pènjako	p è nj a k o	p E ñ a k o
pènohie(j)o	p è n o h ie ( j ) o	p E n o h i ( j ) o
piehie	p ie h ie	p i h i
pie(j)ako(w)èq	p ie ( j ) a k o ( w ) è q	p i ( j ) a k o ( w ) E '
piekie(j)aq	p ie k ie ( j ) a q	p i k i ( j ) a '
piekopieko	p ie k o p ie k o	p i k o p i k o
piekoöie	p ie k o ö ie	p i k o ' o i
pienahaäq	p ie n a h a ä q	p i n a h a ' a '
pieöhaäq	p ie ö h a ä q	p i ' o h a ' a '
piepienaq	p ie p ie n a q	p i p i n a '
poedaq	p oe d a q	p u d a '
poedarie	p oe d a r ie	p u d a r i
poekoie	p oe k o ie	p u k o i
poeoenjaq	p oeoe nj a q	p u ' u ñ a '
poepoedoe	p oe p oe d oe	p u p u d u
poeqä	p oe qä	p u ' a
poerieho	p oe r ie h o	p u r i h o
pohaie	p o h a ie	p o h a i
pohoie(j)aoda	p o h o ie ( j ) a o d a	p o h o i ( j ) a o d a
pöhöjaq	p ö h ö j a q	p u̇ h u̇ j a '
pöhöjaq	p ö h ö j a q	p u̇ h u̇ j a '
poporo	p o p o r o	p o p o r o
poöpèkie(j)aq	p o ö p è k ie ( j ) a q	p o ' o p E k i ( j ) a '
radjo	r a dj o	r a j o
rapat	r a p a t	r a p a t
taka	t a k a	t a k a
tjientjien	tj ie n tj ie n	c i n c i n
wakiepörö	w a k ie p ö r ö	w a k i p u̇ r u̇
(è)kahaèq	( è ) k a h a è q	( E ) k a h a E '
adoe(w)a	a d oe ( w ) a	a d u ( w ) a
akoloe	a k o l oe	a k o l u
a(o)pa	a ( o ) p a	a ( o ) p a
adieba	a d ie b a	a d i b a
akieäkiena	a k ie ä k ie n a	a k i ' a k i n a
adieba hie adoe(w)a	a d ie b a # h ie # a d oe ( w ) a	a d i b a # h i # a d u ( w ) a
arieba hie aroe(w)a	a r ie b a # h ie # a r oe ( w ) a	a r i b a # h i # a r u ( w ) a
aliebĕ hie adoe(w)ĕ	a l ie b ĕ # h ie # a d oe ( w ) ĕ	a l i b ė # h i # a d u ( w ) ė
a(o)pa hie a(o)pa	a ( o ) p a # h ie # a ( o ) p a	a ( o ) p a # h i # a ( o ) p a
abaiekahaèq	a b a ie k a h a è q	a b a i k a h a E '
kiepa(a)oeq	k ie p a ( a ) oe q	k i p a ( a ) u '
kiepa(a)oeq hie (è)kahaèq	k ie p a ( a ) oe q # h ie # ( è ) k a h a è q	k i p a ( a ) u ' # h i # ( E ) k a h a E '
kiepa(a)oeq hie adoe(w)a	k ie p a ( a ) oe q # h ie # a d oe ( w ) a	k i p a ( a ) u ' # h i # a d u ( w ) a
kiepa(a)oeq hie aroe(w)a	k ie p a ( a ) oe q # h ie # a r oe ( w ) a	k i p a ( a ) u ' # h i # a r u ( w ) a
kiepa(a)oeq hie adoe(w)ĕ	k ie p a ( a ) oe q # h ie # a d oe ( w ) ĕ	k i p a ( a ) u ' # h i # a d u ( w ) ė
(è)kahaèq taka	( è ) k a h a è q # t a k a	( E ) k a h a E ' # t a k a
(è)kahaèq taka hie (è)kahaèq	( è ) k a h a è q # t a k a # h ie # ( è ) k a h a è q	( E ) k a h a E ' # t a k a # h i # ( E ) k a h a E '
(è)kahaèq taka hie kiepa(a)oeq	( è ) k a h a è q # t a k a # h ie # k ie p a ( a ) oe q	( E ) k a h a E ' # t a k a # h i # k i p a ( a ) u '
(è)kahaèq taka hie kiepa(a)oeq, hie (è)kahaèq	( è ) k a h a è q # t a k a # h ie # k ie p a ( a ) oe q , # h ie # ( è ) k a h a è q	( E ) k a h a E ' # t a k a # h i # k i p a ( a ) u ' , # h i # ( E ) k a h a E '
adoe(w)a taka	a d oe ( w ) a # t a k a	a d u ( w ) a # t a k a
aroe(w)a taka	a r oe ( w ) a # t a k a	a r u ( w ) a # t a k a
adoe(w)ĕ taka	a d oe ( w ) ĕ # t a k a	a d u ( w ) ė # t a k a
adoe(w)a taka hie (è)kahaèq	a d oe ( w ) a # t a k a # h ie # ( è ) k a h a è q	a d u ( w ) a # t a k a # h i # ( E ) k a h a E '
aroe(w)a taka hie (è)kahaèq	a r oe ( w ) a # t a k a # h ie # ( è ) k a h a è q	a r u ( w ) a # t a k a # h i # ( E ) k a h a E '
adoe(w)ĕ taka hie (è)kahaèq	a d oe ( w ) ĕ # t a k a # h ie # ( è ) k a h a è q	a d u ( w ) ė # t a k a # h i # ( E ) k a h a E '
adoe(w)a taka hie kiepa(a)oeq	a d oe ( w ) a # t a k a # h ie # k ie p a ( a ) oe q	a d u ( w ) a # t a k a # h i # k i p a ( a ) u '
aroe(w)a taka hie kiepa(a)oeq	a r oe ( w ) a # t a k a # h ie # k ie p a ( a ) oe q	a r u ( w ) a # t a k a # h i # k i p a ( a ) u '
adoe(w)ĕ taka hie kiepa(a)oeq	a d oe ( w ) ĕ # t a k a # h ie # k ie p a ( a ) oe q	a d u ( w ) ė # t a k a # h i # k i p a ( a ) u '
akaloe taka	a k a l oe # t a k a	a k a l u # t a k a
akoloe taka hie kiepa(a)oeq	a k o l oe # t a k a # h ie # k ie p a ( a ) oe q	a k o l u # t a k a # h i # k i p a ( a ) u '
a(o)pa taka	a ( o ) p a # t a k a	a ( o ) p a # t a k a
a(o)fa taka	a ( o ) f a # t a k a	a ( o ) f a # t a k a
a(o)pa taka hie kiepa(a)oeq	a ( o ) p a # t a k a # h ie # k ie p a ( a ) oe q	a ( o ) p a # t a k a # h i # k i p a ( a ) u '
a(o)fa taka hie kiepa(a)oeq	a ( o ) f a # t a k a # h ie # k ie p a ( a ) oe q	a ( o ) f a # t a k a # h i # k i p a ( a ) u '
adieba taka	a d ie b a # t a k a	a d i b a # t a k a
arieba taka	a r ie b a # t a k a	a r i b a # t a k a
aliebĕ taka	a l ie b ĕ # t a k a	a l i b ė # t a k a
kiepa(a)oeq taka	k ie p a ( a ) oe q # t a k a	k i p a ( a ) u ' # t a k a
kiefa(a)oeq taka	k ie f a ( a ) oe q # t a k a	k i f a ( a ) u ' # t a k a
(è)kahaèq koedodoka	( è ) k a h a è q # k oe d o d o k a	( E ) k a h a E ' # k u d o d o k a
